# Disqus
disqus.com	prod.disqus.map.fastlylb.net
www.disqus.com	prod.disqus.map.fastlylb.net
about.disqus.com	429754g4.secure001.hubspot.net
blog.disqus.com	429754g4.secure0015.hubspot.net
help.disqus.com	prod.disqus.map.fastlylb.net
status.disqus.com	fjkv5pmjhd1w.stspg-customer.com
disquscdn.com	www.disquscdn.com.cdn.cloudflare.net
www.disquscdn.com	www.disquscdn.com.cdn.cloudflare.net
a.disquscdn.com	l2.shared.us-eu.fastly.net
c.disquscdn.com	c.disquscdn.com.cdn.cloudflare.net
imagerator.disquscdn.com	l2.shared.us-eu.fastly.net
media.disquscdn.com	l2.shared.us-eu.fastly.net
tempest.disquscdn.com	l2.shared.us-eu.fastly.net
uploads.disquscdn.com	l2.shared.us-eu.fastly.net

# Dropbox
dropbox.com	www.dropbox-dns.com
www.dropbox.com	www.dropbox-dns.com
aem.dropbox.com	-
api.dropbox.com	api.dropbox-dns.com
api-content.dropbox.com	edge-block-api.dropbox-dns.com
api-content-photos.dropbox.com	edge-block-previews-video-live.dropbox-dns.com
api-d.dropbox.com	d.v.dropbox.com
api-notify.dropbox.com	api.v.dropbox.com
block.dropbox.com	block.dropbox-dns.com
blog.dropbox.com	-
blogs.dropbox.com	-
bolt.dropbox.com	bolt.v.dropbox.com
client.dropbox.com	client.dropbox-dns.com
client0.dropbox.com	client.dropbox.com
client1.dropbox.com	client.dropbox.com
client2.dropbox.com	client.dropbox.com
client3.dropbox.com	client.dropbox.com
client4.dropbox.com	client.dropbox.com
client5.dropbox.com	client.dropbox.com
client6.dropbox.com	client.dropbox.com
client7.dropbox.com	client.dropbox.com
client8.dropbox.com	client.dropbox.com
client9.dropbox.com	client.dropbox.com
client10.dropbox.com	client.dropbox.com
client11.dropbox.com	client.dropbox.com
client12.dropbox.com	client.dropbox.com
client13.dropbox.com	client.dropbox.com
client14.dropbox.com	client.dropbox.com
client15.dropbox.com	client.dropbox.com
client16.dropbox.com	client.dropbox.com
client17.dropbox.com	client.dropbox.com
client18.dropbox.com	client.dropbox.com
client19.dropbox.com	client.dropbox.com
client20.dropbox.com	client.dropbox.com
client21.dropbox.com	client.dropbox.com
client22.dropbox.com	client.dropbox.com
client23.dropbox.com	client.dropbox.com
client24.dropbox.com	client.dropbox.com
client25.dropbox.com	client.dropbox.com
client26.dropbox.com	client.dropbox.com
client27.dropbox.com	client.dropbox.com
client28.dropbox.com	client.dropbox.com
client29.dropbox.com	client.dropbox.com
client30.dropbox.com	client.dropbox.com
client31.dropbox.com	client.dropbox.com
client32.dropbox.com	client.dropbox.com
client33.dropbox.com	client.dropbox.com
client34.dropbox.com	client.dropbox.com
client35.dropbox.com	client.dropbox.com
client36.dropbox.com	client.dropbox.com
client37.dropbox.com	client.dropbox.com
client38.dropbox.com	client.dropbox.com
client39.dropbox.com	client.dropbox.com
client40.dropbox.com	client.dropbox.com
client41.dropbox.com	client.dropbox.com
client42.dropbox.com	client.dropbox.com
client43.dropbox.com	client.dropbox.com
client44.dropbox.com	client.dropbox.com
client45.dropbox.com	client.dropbox.com
client46.dropbox.com	client.dropbox.com
client47.dropbox.com	client.dropbox.com
client48.dropbox.com	client.dropbox.com
client49.dropbox.com	client.dropbox.com
client50.dropbox.com	client.dropbox.com
client51.dropbox.com	client.dropbox.com
client52.dropbox.com	client.dropbox.com
client53.dropbox.com	client.dropbox.com
client54.dropbox.com	client.dropbox.com
client55.dropbox.com	client.dropbox.com
client56.dropbox.com	client.dropbox.com
client57.dropbox.com	client.dropbox.com
client58.dropbox.com	client.dropbox.com
client59.dropbox.com	client.dropbox.com
client60.dropbox.com	client.dropbox.com
client61.dropbox.com	client.dropbox.com
client62.dropbox.com	client.dropbox.com
client63.dropbox.com	client.dropbox.com
client64.dropbox.com	client.dropbox.com
client65.dropbox.com	client.dropbox.com
client66.dropbox.com	client.dropbox.com
client67.dropbox.com	client.dropbox.com
client68.dropbox.com	client.dropbox.com
client69.dropbox.com	client.dropbox.com
client70.dropbox.com	client.dropbox.com
client71.dropbox.com	client.dropbox.com
client72.dropbox.com	client.dropbox.com
client73.dropbox.com	client.dropbox.com
client74.dropbox.com	client.dropbox.com
client75.dropbox.com	client.dropbox.com
client76.dropbox.com	client.dropbox.com
client77.dropbox.com	client.dropbox.com
client78.dropbox.com	client.dropbox.com
client79.dropbox.com	client.dropbox.com
client80.dropbox.com	client.dropbox.com
client81.dropbox.com	client.dropbox.com
client82.dropbox.com	client.dropbox.com
client83.dropbox.com	client.dropbox.com
client84.dropbox.com	client.dropbox.com
client85.dropbox.com	client.dropbox.com
client86.dropbox.com	client.dropbox.com
client87.dropbox.com	client.dropbox.com
client88.dropbox.com	client.dropbox.com
client89.dropbox.com	client.dropbox.com
client90.dropbox.com	client.dropbox.com
client91.dropbox.com	client.dropbox.com
client92.dropbox.com	client.dropbox.com
client93.dropbox.com	client.dropbox.com
client94.dropbox.com	client.dropbox.com
client95.dropbox.com	client.dropbox.com
client96.dropbox.com	client.dropbox.com
client97.dropbox.com	client.dropbox.com
client98.dropbox.com	client.dropbox.com
client99.dropbox.com	client.dropbox.com
client-cf.dropbox.com	client.dropbox-dns.com
client-lb.dropbox.com	client.dropbox-dns.com
client-web.dropbox.com	client.dropbox-dns.com
d.dropbox.com	d.v.dropbox.com
dl.dropbox.com	edge-block-www.dropbox-dns.com
dl-client1.dropbox.com	block.dropbox.com
dl-client2.dropbox.com	block.dropbox.com
dl-client3.dropbox.com	block.dropbox.com
dl-client4.dropbox.com	block.dropbox.com
dl-client5.dropbox.com	block.dropbox.com
dl-client6.dropbox.com	block.dropbox.com
dl-client7.dropbox.com	block.dropbox.com
dl-client8.dropbox.com	block.dropbox.com
dl-client9.dropbox.com	block.dropbox.com
dl-client10.dropbox.com	block.dropbox.com
dl-client11.dropbox.com	block.dropbox.com
dl-client12.dropbox.com	block.dropbox.com
dl-client13.dropbox.com	block.dropbox.com
dl-client14.dropbox.com	block.dropbox.com
dl-client15.dropbox.com	block.dropbox.com
dl-client16.dropbox.com	block.dropbox.com
dl-client17.dropbox.com	block.dropbox.com
dl-client18.dropbox.com	block.dropbox.com
dl-client19.dropbox.com	block.dropbox.com
dl-client20.dropbox.com	block.dropbox.com
dl-client21.dropbox.com	block.dropbox.com
dl-client22.dropbox.com	block.dropbox.com
dl-client23.dropbox.com	block.dropbox.com
dl-client24.dropbox.com	block.dropbox.com
dl-client25.dropbox.com	block.dropbox.com
dl-client26.dropbox.com	block.dropbox.com
dl-client27.dropbox.com	block.dropbox.com
dl-client28.dropbox.com	block.dropbox.com
dl-client29.dropbox.com	block.dropbox.com
dl-client30.dropbox.com	block.dropbox.com
dl-client31.dropbox.com	block.dropbox.com
dl-client32.dropbox.com	block.dropbox.com
dl-client33.dropbox.com	block.dropbox.com
dl-client34.dropbox.com	block.dropbox.com
dl-client35.dropbox.com	block.dropbox.com
dl-client36.dropbox.com	block.dropbox.com
dl-client37.dropbox.com	block.dropbox.com
dl-client38.dropbox.com	block.dropbox.com
dl-client39.dropbox.com	block.dropbox.com
dl-client40.dropbox.com	block.dropbox.com
dl-client41.dropbox.com	block.dropbox.com
dl-client42.dropbox.com	block.dropbox.com
dl-client43.dropbox.com	block.dropbox.com
dl-client44.dropbox.com	block.dropbox.com
dl-client45.dropbox.com	block.dropbox.com
dl-client46.dropbox.com	block.dropbox.com
dl-client47.dropbox.com	block.dropbox.com
dl-client48.dropbox.com	block.dropbox.com
dl-client49.dropbox.com	block.dropbox.com
dl-client50.dropbox.com	block.dropbox.com
dl-client51.dropbox.com	block.dropbox.com
dl-client52.dropbox.com	block.dropbox.com
dl-client53.dropbox.com	block.dropbox.com
dl-client54.dropbox.com	block.dropbox.com
dl-client55.dropbox.com	block.dropbox.com
dl-client56.dropbox.com	block.dropbox.com
dl-client57.dropbox.com	block.dropbox.com
dl-client58.dropbox.com	block.dropbox.com
dl-client59.dropbox.com	block.dropbox.com
dl-client60.dropbox.com	block.dropbox.com
dl-client61.dropbox.com	block.dropbox.com
dl-client62.dropbox.com	block.dropbox.com
dl-client63.dropbox.com	block.dropbox.com
dl-client64.dropbox.com	block.dropbox.com
dl-client65.dropbox.com	block.dropbox.com
dl-client66.dropbox.com	block.dropbox.com
dl-client67.dropbox.com	block.dropbox.com
dl-client68.dropbox.com	block.dropbox.com
dl-client69.dropbox.com	block.dropbox.com
dl-client70.dropbox.com	block.dropbox.com
dl-client71.dropbox.com	block.dropbox.com
dl-client72.dropbox.com	block.dropbox.com
dl-client73.dropbox.com	block.dropbox.com
dl-client74.dropbox.com	block.dropbox.com
dl-client75.dropbox.com	block.dropbox.com
dl-client76.dropbox.com	block.dropbox.com
dl-client77.dropbox.com	block.dropbox.com
dl-client78.dropbox.com	block.dropbox.com
dl-client79.dropbox.com	block.dropbox.com
dl-client80.dropbox.com	block.dropbox.com
dl-client81.dropbox.com	block.dropbox.com
dl-client82.dropbox.com	block.dropbox.com
dl-client83.dropbox.com	block.dropbox.com
dl-client84.dropbox.com	block.dropbox.com
dl-client85.dropbox.com	block.dropbox.com
dl-client86.dropbox.com	block.dropbox.com
dl-client87.dropbox.com	block.dropbox.com
dl-client88.dropbox.com	block.dropbox.com
dl-client89.dropbox.com	block.dropbox.com
dl-client90.dropbox.com	block.dropbox.com
dl-client91.dropbox.com	block.dropbox.com
dl-client92.dropbox.com	block.dropbox.com
dl-client93.dropbox.com	block.dropbox.com
dl-client94.dropbox.com	block.dropbox.com
dl-client95.dropbox.com	block.dropbox.com
dl-client96.dropbox.com	block.dropbox.com
dl-client97.dropbox.com	block.dropbox.com
dl-client98.dropbox.com	block.dropbox.com
dl-client99.dropbox.com	block.dropbox.com
dl-client100.dropbox.com	block.dropbox.com
dl-client101.dropbox.com	block.dropbox.com
dl-client102.dropbox.com	block.dropbox.com
dl-client103.dropbox.com	block.dropbox.com
dl-client104.dropbox.com	block.dropbox.com
dl-client105.dropbox.com	block.dropbox.com
dl-client106.dropbox.com	block.dropbox.com
dl-client107.dropbox.com	block.dropbox.com
dl-client108.dropbox.com	block.dropbox.com
dl-client109.dropbox.com	block.dropbox.com
dl-client110.dropbox.com	block.dropbox.com
dl-client111.dropbox.com	block.dropbox.com
dl-client112.dropbox.com	block.dropbox.com
dl-client113.dropbox.com	block.dropbox.com
dl-client114.dropbox.com	block.dropbox.com
dl-client115.dropbox.com	block.dropbox.com
dl-client116.dropbox.com	block.dropbox.com
dl-client117.dropbox.com	block.dropbox.com
dl-client118.dropbox.com	block.dropbox.com
dl-client119.dropbox.com	block.dropbox.com
dl-client120.dropbox.com	block.dropbox.com
dl-client121.dropbox.com	block.dropbox.com
dl-client122.dropbox.com	block.dropbox.com
dl-client123.dropbox.com	block.dropbox.com
dl-client124.dropbox.com	block.dropbox.com
dl-client125.dropbox.com	block.dropbox.com
dl-client126.dropbox.com	block.dropbox.com
dl-client127.dropbox.com	block.dropbox.com
dl-client128.dropbox.com	block.dropbox.com
dl-client129.dropbox.com	block.dropbox.com
dl-debug.dropbox.com	block-debug.x.dropbox.com
dl-doc.dropbox.com	dl.dropbox.com
dl-web.dropbox.com	edge-block-www.dropbox-dns.com
files.dropbox.com	block-www.dropbox-dns.com
forums.dropbox.com	-
linux.dropbox.com	-
m.dropbox.com	edge-misc.dropbox-dns.com
marketing.dropbox.com	-
opensource.dropbox.com	static.v.dropbox.com
paper.dropbox.com	-
photo.dropbox.com	www.dropbox-dns.com
photos.dropbox.com	www.dropbox-dns.com
photos-1.dropbox.com	edge-block-previews-video-live.dropbox-dns.com
photos-2.dropbox.com	edge-block-previews-video-live.dropbox-dns.com
photos-3.dropbox.com	edge-block-previews-video-live.dropbox-dns.com
photos-4.dropbox.com	edge-block-previews-video-live.dropbox-dns.com
photos-5.dropbox.com	edge-block-previews-video-live.dropbox-dns.com
photos-6.dropbox.com	edge-block-previews-video-live.dropbox-dns.com
photos-thumb.dropbox.com	edge-block-previews-video-live.dropbox-dns.com
showbox.dropbox.com	block-www.dropbox-dns.com
snapengage.dropbox.com	-
status.dropbox.com	-
support.dropbox.com	www.v.dropbox.com
texter.dropbox.com	www.v.dropbox.com
photos-thumb.x.dropbox.com	-
db.tt	-
api.dropboxapi.com	api.dropbox-dns.com
content.dropboxapi.com	edge-block-api.dropbox-dns.com
dropboxstatic.com	static.v.dropbox.com
www.dropboxstatic.com	static.v.dropbox.com
cf.dropboxstatic.com	-
cfl.dropboxstatic.com	cfl.dropboxstatic.com.cdn.cloudflare.net
clientupdates.dropboxstatic.com	-
dbxlocal.dropboxstatic.com	static.v.dropbox.com
dl.dropboxusercontent.com	edge-block-www.dropbox-dns.com
getdropbox.com	edge-misc.dropbox-dns.com
www.getdropbox.com	edge-misc.dropbox-dns.com
dl.getdropbox.com	edge-misc.dropbox-dns.com
files.getdropbox.com	edge-misc.dropbox-dns.com
log.getdropbox.com	edge-misc.dropbox-dns.com

# DuckDuckGo
duckduckgo.com	duckduckgo.com
www.duckduckgo.com	duckduckgo.com
ac.duckduckgo.com	duckduckgo.com
api.duckduckgo.com	ff.duckduckgo.com
chrome.duckduckgo.com	ff.duckduckgo.com
ff.duckduckgo.com	ff.duckduckgo.com
help.duckduckgo.com	duckduckgo.com
i.duckduckgo.com	duckduckgo.com
icons.duckduckgo.com	icons.duckduckgo.com
images.duckduckgo.com	duckduckgo.com
karma.duckduckgo.com	duckduckgo.com
news.duckduckgo.com	duckduckgo.com
next.duckduckgo.com	duckduckgo.com
proxy.duckduckgo.com	icons.duckduckgo.com
r.duckduckgo.com	duckduckgo.com
safe.duckduckgo.com	-
start.duckduckgo.com	duckduckgo.com
support.duckduckgo.com	duckduckgo.com
watrcoolr.duckduckgo.com	duckduckgo.com

# Facebook
facebook.com	star-mini.c10r.facebook.com
www.facebook.com	star-mini.c10r.facebook.com
0-edge-chat.facebook.com	star.c10r.facebook.com
1-edge-chat.facebook.com	star.c10r.facebook.com
2-edge-chat.facebook.com	star.c10r.facebook.com
3-edge-chat.facebook.com	star.c10r.facebook.com
4-edge-chat.facebook.com	star.c10r.facebook.com
5-edge-chat.facebook.com	star.c10r.facebook.com
6-edge-chat.facebook.com	star.c10r.facebook.com
api.facebook.com	star.c10r.facebook.com
api2.facebook.com	z-1.c10r.facebook.com
api-read.facebook.com	star.c10r.facebook.com
apps.facebook.com	star.c10r.facebook.com
attachments.facebook.com	star.c10r.facebook.com
badge.facebook.com	star.c10r.facebook.com
b-api.facebook.com	star-mini.c10r.facebook.com
apps.beta.facebook.com	latest.c10r.facebook.com
b-graph.facebook.com	star-mini.c10r.facebook.com
bigzipfiles.facebook.com	scontent.xx.fbcdn.net
business.facebook.com	star.c10r.facebook.com
b-www.facebook.com	star-mini.c10r.facebook.com
c.facebook.com	star.c10r.facebook.com
check4.facebook.com	star.c10r.facebook.com
check6.facebook.com	star.c10r.facebook.com
code.facebook.com	star.c10r.facebook.com
connect.facebook.com	star-mini.c10r.facebook.com
contactimporter.facebook.com	star.c10r.facebook.com
d.facebook.com	z-m.c10r.facebook.com
developer.facebook.com	star.c10r.facebook.com
developers.facebook.com	developers.c10r.facebook.com
edge-chat.facebook.com	star.c10r.facebook.com
edge-mqtt.facebook.com	mqtt.c10r.facebook.com
error.facebook.com	star.c10r.facebook.com
graph.facebook.com	star.c10r.facebook.com
graph2.facebook.com	z-1.c10r.facebook.com
l.facebook.com	z-m.c10r.facebook.com
lm.facebook.com	z-m.c10r.facebook.com
login.facebook.com	star.c10r.facebook.com
m.facebook.com	star-mini.c10r.facebook.com
mbasic.facebook.com	star.c10r.facebook.com
mqtt.facebook.com	mqtt.c10r.facebook.com
mqtt-mini.facebook.com	mqtt-mini.c10r.facebook.com
mtouch.facebook.com	star.c10r.facebook.com
orcart.facebook.com	mqtt.c10r.facebook.com
research.facebook.com	star.c10r.facebook.com
rupload.facebook.com	star.c10r.facebook.com
secure.facebook.com	secure.c10r.facebook.com
snaptu-p1.facebook.com	snaptu-p1.c10r.facebook.com
snaptu-p2.facebook.com	snaptu-p1.c10r.facebook.com
snaptu-z.facebook.com	snaptu-mini.c10r.facebook.com
ssl.facebook.com	star.c10r.facebook.com
s-static.facebook.com	star.c10r.facebook.com
star.facebook.com	star.c10r.facebook.com
static.facebook.com	star.c10r.facebook.com
staticxx.facebook.com	scontent.xx.fbcdn.net
touch.facebook.com	star.c10r.facebook.com
upload.facebook.com	star.c10r.facebook.com
vupload.facebook.com	star.c10r.facebook.com
vupload-edge.facebook.com	star.c10r.facebook.com
vupload2.facebook.com	star.c10r.facebook.com
web.facebook.com	z-1.c10r.facebook.com
work.facebook.com	star.c10r.facebook.com
work-m.facebook.com	star.c10r.facebook.com
www2.facebook.com	z-1.c10r.facebook.com
af-za.facebook.com	star.c10r.facebook.com
ar-ar.facebook.com	star.c10r.facebook.com
az-az.facebook.com	star.c10r.facebook.com
be-by.facebook.com	star.c10r.facebook.com
bg-bg.facebook.com	star.c10r.facebook.com
bn-in.facebook.com	star.c10r.facebook.com
bs-ba.facebook.com	star.c10r.facebook.com
ca-es.facebook.com	star.c10r.facebook.com
cs-cz.facebook.com	star.c10r.facebook.com
cy-gb.facebook.com	star.c10r.facebook.com
da-dk.facebook.com	star.c10r.facebook.com
de-de.facebook.com	star.c10r.facebook.com
el-gr.facebook.com	star.c10r.facebook.com
en-gb.facebook.com	star.c10r.facebook.com
eo-eo.facebook.com	star.c10r.facebook.com
es-es.facebook.com	star.c10r.facebook.com
es-la.facebook.com	star.c10r.facebook.com
et-ee.facebook.com	star.c10r.facebook.com
eu-es.facebook.com	star.c10r.facebook.com
fa-ir.facebook.com	star.c10r.facebook.com
fb-lt.facebook.com	star.c10r.facebook.com
fi-fi.facebook.com	star.c10r.facebook.com
fo-fo.facebook.com	star.c10r.facebook.com
fr-ca.facebook.com	star.c10r.facebook.com
fr-fr.facebook.com	star.c10r.facebook.com
fy-nl.facebook.com	star.c10r.facebook.com
ga-ie.facebook.com	star.c10r.facebook.com
gl-es.facebook.com	star.c10r.facebook.com
he-il.facebook.com	star.c10r.facebook.com
hi-in.facebook.com	star.c10r.facebook.com
hr-hr.facebook.com	star.c10r.facebook.com
hu-hu.facebook.com	star.c10r.facebook.com
hy-am.facebook.com	star.c10r.facebook.com
id-id.facebook.com	star.c10r.facebook.com
is-is.facebook.com	star.c10r.facebook.com
it-it.facebook.com	star.c10r.facebook.com
ja-jp.facebook.com	star.c10r.facebook.com
ka-ge.facebook.com	star.c10r.facebook.com
ko-kr.facebook.com	star.c10r.facebook.com
ku-tr.facebook.com	star.c10r.facebook.com
la-va.facebook.com	star.c10r.facebook.com
lt-lt.facebook.com	star.c10r.facebook.com
lv-lv.facebook.com	star.c10r.facebook.com
mk-mk.facebook.com	star.c10r.facebook.com
ml-in.facebook.com	star.c10r.facebook.com
ms-my.facebook.com	star.c10r.facebook.com
nb-no.facebook.com	star.c10r.facebook.com
ne-np.facebook.com	star.c10r.facebook.com
nl-nl.facebook.com	star.c10r.facebook.com
nn-no.facebook.com	star.c10r.facebook.com
or-in.facebook.com	star.c10r.facebook.com
pa-in.facebook.com	star.c10r.facebook.com
pl-pl.facebook.com	star.c10r.facebook.com
ps-af.facebook.com	star.c10r.facebook.com
pt-br.facebook.com	star.c10r.facebook.com
pt-pt.facebook.com	star.c10r.facebook.com
ro-ro.facebook.com	star.c10r.facebook.com
ru-ru.facebook.com	star.c10r.facebook.com
sk-sk.facebook.com	star.c10r.facebook.com
sl-si.facebook.com	star.c10r.facebook.com
sq-al.facebook.com	star.c10r.facebook.com
sr-rs.facebook.com	star.c10r.facebook.com
sv-se.facebook.com	star.c10r.facebook.com
sw-ke.facebook.com	star.c10r.facebook.com
ta-in.facebook.com	star.c10r.facebook.com
te-in.facebook.com	star.c10r.facebook.com
th-th.facebook.com	star.c10r.facebook.com
tl-ph.facebook.com	star.c10r.facebook.com
tr-tr.facebook.com	star.c10r.facebook.com
uk-ua.facebook.com	star.c10r.facebook.com
ur-pk.facebook.com	star.c10r.facebook.com
vi-vn.facebook.com	star.c10r.facebook.com
zh-cn.facebook.com	star.c10r.facebook.com
zh-hk.facebook.com	star.c10r.facebook.com
zh-tw.facebook.com	star.c10r.facebook.com
beta.facebook.net	latest.c10r.facebook.com
connect.facebook.net	scontent.xx.fbcdn.net
fb.com	star-mini.c10r.facebook.com
www.fb.com	star-mini.c10r.facebook.com
360video.fb.com	lb.wordpress.com
content.fb.com	mkto-sj160116.com
creativehub.fb.com	star-mini.c10r.facebook.com
dev.fb.com	developers.c10r.facebook.com
events.fb.com	*.go-vip.co
files.fb.com	-
free.fb.com	z-m.c10r.facebook.com.
go.fb.com	sj16.mktossl.com
h.fb.com	headers-regional.vvv.facebook.com
img.fb.com	-
insights.fb.com	vip-lb.wordpress.com
inspired.fb.com	*.go-vip.co
instantarticles.fb.com	lb.wordpress.com
investor.fb.com	webfarm-31.q4web.com
live.fb.com	lb.wordpress.com
managingbias.fb.com	lb.wordpress.com
media.fb.com	vip-lb.wordpress.com
messenger.fb.com	*.go-vip.co
messengerplatform.fb.com	*.go-vip.co
newsfeed.fb.com	*.go-vip.co
newsroom.fb.com	vip-lb.wordpress.com
nonprofits.fb.com	*.go-vip.co
pay.fb.com	star-mini.c10r.facebook.com
phabricator.fb.com	extern.c10r.facebook.com
portal.fb.com	star.c10r.facebook.com
reports.fb.com	star-mini.c10r.facebook.com
research.fb.com	*.go-vip.co
rightsmanager.fb.com	lb.wordpress.com
s.fb.com	star-mini.c10r.facebook.com
search.fb.com	star.c10r.facebook.com
sftp.fb.com	sftp-ext.fb.com
shemeansbusiness.fb.com	*.go-vip.co
signal.fb.com	app-production-node-lb-1465891913.us-west-1.elb.amazonaws.com
sustainability.fb.com	lb.wordpress.com
techprep.fb.com	*.go-vip.co
threatexchange.fb.com	-
vsp.fb.com	prn-vsp.fb.com
yearinreview.fb.com	vip-lb.wordpress.com
yourbusinessstory.fb.com	star.c10r.facebook.com
fb.me	star-mini.c10r.facebook.com
www.fb.me	star-mini.c10r.facebook.com
a5.fb.me	star-mini.c10r.facebook.com
api.fb.me	star-mini.c10r.facebook.com
on.fb.me	cname.bitly.com
fbcdn.net	star-mini.c10r.facebook.com
www.fbcdn.net	star-mini.c10r.facebook.com
external.xx.fbcdn.net	scontent.xx.fbcdn.net
external-ams.xx.fbcdn.net	-
external-ams3-1.xx.fbcdn.net	-
external-amt.xx.fbcdn.net	-
external-amt2-1.xx.fbcdn.net	-
external-arn.xx.fbcdn.net	-
external-arn2-1.xx.fbcdn.net	-
external-atl.xx.fbcdn.net	-
external-atl3-1.xx.fbcdn.net	-
external-bog.xx.fbcdn.net	-
external-bog1-1.xx.fbcdn.net	-
external-bom.xx.fbcdn.net	-
external-bom1-1.xx.fbcdn.net	-
external-bru.xx.fbcdn.net	-
external-bru2-1.xx.fbcdn.net	-
external-cai.xx.fbcdn.net	-
external-cai1-1.xx.fbcdn.net	-
external-cdg.xx.fbcdn.net	-
external-cdg2-1.xx.fbcdn.net	-
external-cdt.xx.fbcdn.net	-
external-cdt1-1.xx.fbcdn.net	-
external-dft.xx.fbcdn.net	-
external-dft4-1.xx.fbcdn.net	-
external-dft4-2.xx.fbcdn.net	-
external-dft4-3.xx.fbcdn.net	-
external-eze.xx.fbcdn.net	-
external-eze1-1.xx.fbcdn.net	-
external-frt.xx.fbcdn.net	-
external-frt3-1.xx.fbcdn.net	-
external-frt3-2.xx.fbcdn.net	-
external-frx.xx.fbcdn.net	-
external-frx5-1.xx.fbcdn.net	-
external-gru.xx.fbcdn.net	-
external-gru2-1.xx.fbcdn.net	-
external-gru2-2.xx.fbcdn.net	-
external-hkg.xx.fbcdn.net	-
external-hkg3-1.xx.fbcdn.net	-
external-hkg3-2.xx.fbcdn.net	-
external-iad.xx.fbcdn.net	-
external-iad3-1.xx.fbcdn.net	-
external-icn.xx.fbcdn.net	-
external-icn1-1.xx.fbcdn.net	-
external-jnb.xx.fbcdn.net	-
external-jnb1-1.xx.fbcdn.net	-
external-kut.xx.fbcdn.net	-
external-kut2-1.xx.fbcdn.net	-
external-lax.xx.fbcdn.net	-
external-lax3-1.xx.fbcdn.net	-
external-lax3-2.xx.fbcdn.net	-
external-lga.xx.fbcdn.net	-
external-lga3-1.xx.fbcdn.net	-
external-lhr.xx.fbcdn.net	-
external-lhr3-1.xx.fbcdn.net	-
external-lht.xx.fbcdn.net	-
external-lht6-1.xx.fbcdn.net	-
external-mad.xx.fbcdn.net	-
external-mad1-1.xx.fbcdn.net	-
external-mia.xx.fbcdn.net	-
external-mia3-1.xx.fbcdn.net	-
external-mia3-2.xx.fbcdn.net	-
external-mrs.xx.fbcdn.net	-
external-mrs1-1.xx.fbcdn.net	-
external-mxp.xx.fbcdn.net	-
external-mxp1-1.xx.fbcdn.net	-
external-nrt.xx.fbcdn.net	-
external-nrt1-1.xx.fbcdn.net	-
external-ort.xx.fbcdn.net	-
external-ort2-1.xx.fbcdn.net	-
external-ort2-2.xx.fbcdn.net	-
external-otp.xx.fbcdn.net	-
external-otp1-1.xx.fbcdn.net	-
external-scl.xx.fbcdn.net	-
external-scl1-1.xx.fbcdn.net	-
external-sea.xx.fbcdn.net	-
external-sea1-1.xx.fbcdn.net	-
external-sin.xx.fbcdn.net	-
external-sin6-1.xx.fbcdn.net	-
external-sin6-2.xx.fbcdn.net	-
external-sit.xx.fbcdn.net	-
external-sit4-1.xx.fbcdn.net	-
external-sjc.xx.fbcdn.net	-
external-sjc2-1.xx.fbcdn.net	-
external-sof.xx.fbcdn.net	-
external-sof1-1.xx.fbcdn.net	-
external-syd.xx.fbcdn.net	-
external-syd2-1.xx.fbcdn.net	-
external-tpe.xx.fbcdn.net	-
external-tpe1-1.xx.fbcdn.net	-
external-vie.xx.fbcdn.net	-
external-vie1-1.xx.fbcdn.net	-
external-waw.xx.fbcdn.net	-
external-waw1-1.xx.fbcdn.net	-
external-yyz.xx.fbcdn.net	-
external-yyz1-1.xx.fbcdn.net	-
scontent.xx.fbcdn.net	scontent.xx.fbcdn.net
scontent-ams.xx.fbcdn.net	-
scontent-ams3-1.xx.fbcdn.net	-
scontent-amt.xx.fbcdn.net	-
scontent-amt2-1.xx.fbcdn.net	-
scontent-arn.xx.fbcdn.net	-
scontent-arn2-1.xx.fbcdn.net	-
scontent-atl.xx.fbcdn.net	-
scontent-atl3-1.xx.fbcdn.net	-
scontent-bog.xx.fbcdn.net	-
scontent-bog1-1.xx.fbcdn.net	-
scontent-bom.xx.fbcdn.net	-
scontent-bom1-1.xx.fbcdn.net	-
scontent-bru.xx.fbcdn.net	-
scontent-bru2-1.xx.fbcdn.net	-
scontent-cai.xx.fbcdn.net	-
scontent-cai1-1.xx.fbcdn.net	-
scontent-cdg.xx.fbcdn.net	-
scontent-cdg2-1.xx.fbcdn.net	-
scontent-cdt.xx.fbcdn.net	-
scontent-cdt1-1.xx.fbcdn.net	-
scontent-dft.xx.fbcdn.net	-
scontent-dft4-1.xx.fbcdn.net	-
scontent-dft4-2.xx.fbcdn.net	-
scontent-dft4-3.xx.fbcdn.net	-
scontent-eze.xx.fbcdn.net	-
scontent-eze1-1.xx.fbcdn.net	-
scontent-frt.xx.fbcdn.net	-
scontent-frt3-1.xx.fbcdn.net	-
scontent-frt3-2.xx.fbcdn.net	-
scontent-frx.xx.fbcdn.net	-
scontent-frx5-1.xx.fbcdn.net	-
scontent-gru.xx.fbcdn.net	-
scontent-gru2-1.xx.fbcdn.net	-
scontent-gru2-2.xx.fbcdn.net	-
scontent-hkg.xx.fbcdn.net	-
scontent-hkg3-1.xx.fbcdn.net	-
scontent-hkg3-2.xx.fbcdn.net	-
scontent-iad.xx.fbcdn.net	-
scontent-iad3-1.xx.fbcdn.net	-
scontent-icn.xx.fbcdn.net	-
scontent-icn1-1.xx.fbcdn.net	-
scontent-jnb.xx.fbcdn.net	-
scontent-jnb1-1.xx.fbcdn.net	-
scontent-kut.xx.fbcdn.net	-
scontent-kut2-1.xx.fbcdn.net	-
scontent-lax.xx.fbcdn.net	-
scontent-lax3-1.xx.fbcdn.net	-
scontent-lax3-2.xx.fbcdn.net	-
scontent-lga.xx.fbcdn.net	-
scontent-lga3-1.xx.fbcdn.net	-
scontent-lhr.xx.fbcdn.net	-
scontent-lhr3-1.xx.fbcdn.net	-
scontent-lht.xx.fbcdn.net	-
scontent-lht6-1.xx.fbcdn.net	-
scontent-mad.xx.fbcdn.net	-
scontent-mad1-1.xx.fbcdn.net	-
scontent-mia.xx.fbcdn.net	-
scontent-mia3-1.xx.fbcdn.net	-
scontent-mia3-2.xx.fbcdn.net	-
scontent-mrs.xx.fbcdn.net	-
scontent-mrs1-1.xx.fbcdn.net	-
scontent-mxp.xx.fbcdn.net	-
scontent-mxp1-1.xx.fbcdn.net	-
scontent-nrt.xx.fbcdn.net	-
scontent-nrt1-1.xx.fbcdn.net	-
scontent-ort.xx.fbcdn.net	-
scontent-ort2-1.xx.fbcdn.net	-
scontent-ort2-2.xx.fbcdn.net	-
scontent-otp.xx.fbcdn.net	-
scontent-otp1-1.xx.fbcdn.net	-
scontent-scl.xx.fbcdn.net	-
scontent-scl1-1.xx.fbcdn.net	-
scontent-sea.xx.fbcdn.net	-
scontent-sea1-1.xx.fbcdn.net	-
scontent-sin.xx.fbcdn.net	-
scontent-sin6-1.xx.fbcdn.net	-
scontent-sin6-2.xx.fbcdn.net	-
scontent-sit.xx.fbcdn.net	-
scontent-sit4-1.xx.fbcdn.net	-
scontent-sjc.xx.fbcdn.net	-
scontent-sjc2-1.xx.fbcdn.net	-
scontent-sof.xx.fbcdn.net	-
scontent-sof1-1.xx.fbcdn.net	-
scontent-syd.xx.fbcdn.net	-
scontent-syd2-1.xx.fbcdn.net	-
scontent-tpe.xx.fbcdn.net	-
scontent-tpe1-1.xx.fbcdn.net	-
scontent-vie.xx.fbcdn.net	-
scontent-vie1-1.xx.fbcdn.net	-
scontent-waw.xx.fbcdn.net	-
scontent-waw1-1.xx.fbcdn.net	-
scontent-yyz.xx.fbcdn.net	-
scontent-yyz1-1.xx.fbcdn.net	-
scontent-a.xx.fbcdn.net	scontent.xx.fbcdn.net
scontent-a-ams.xx.fbcdn.net	-
scontent-a-amt.xx.fbcdn.net	-
scontent-a-arn.xx.fbcdn.net	-
scontent-a-atl.xx.fbcdn.net	-
scontent-a-bog.xx.fbcdn.net	-
scontent-a-bom.xx.fbcdn.net	-
scontent-a-bru.xx.fbcdn.net	-
scontent-a-cai.xx.fbcdn.net	-
scontent-a-cdg.xx.fbcdn.net	-
scontent-a-cdt.xx.fbcdn.net	-
scontent-a-dft.xx.fbcdn.net	-
scontent-a-eze.xx.fbcdn.net	-
scontent-a-frt.xx.fbcdn.net	-
scontent-a-frx.xx.fbcdn.net	-
scontent-a-gru.xx.fbcdn.net	-
scontent-a-hkg.xx.fbcdn.net	-
scontent-a-iad.xx.fbcdn.net	-
scontent-a-icn.xx.fbcdn.net	-
scontent-a-jnb.xx.fbcdn.net	-
scontent-a-kut.xx.fbcdn.net	-
scontent-a-lax.xx.fbcdn.net	-
scontent-a-lga.xx.fbcdn.net	-
scontent-a-lhr.xx.fbcdn.net	-
scontent-a-lht.xx.fbcdn.net	-
scontent-a-mad.xx.fbcdn.net	-
scontent-a-mia.xx.fbcdn.net	-
scontent-a-mrs.xx.fbcdn.net	-
scontent-a-mxp.xx.fbcdn.net	-
scontent-a-nrt.xx.fbcdn.net	-
scontent-a-ort.xx.fbcdn.net	-
scontent-a-otp.xx.fbcdn.net	-
scontent-a-scl.xx.fbcdn.net	-
scontent-a-sea.xx.fbcdn.net	-
scontent-a-sin.xx.fbcdn.net	-
scontent-a-sit.xx.fbcdn.net	-
scontent-a-sjc.xx.fbcdn.net	-
scontent-a-sof.xx.fbcdn.net	-
scontent-a-syd.xx.fbcdn.net	-
scontent-a-tpe.xx.fbcdn.net	-
scontent-a-vie.xx.fbcdn.net	-
scontent-a-waw.xx.fbcdn.net	-
scontent-a-yyz.xx.fbcdn.net	-
scontent-b.xx.fbcdn.net	scontent.xx.fbcdn.net
scontent-b-ams.xx.fbcdn.net	-
scontent-b-amt.xx.fbcdn.net	-
scontent-b-arn.xx.fbcdn.net	-
scontent-b-atl.xx.fbcdn.net	-
scontent-b-bog.xx.fbcdn.net	-
scontent-b-bom.xx.fbcdn.net	-
scontent-b-bru.xx.fbcdn.net	-
scontent-b-cai.xx.fbcdn.net	-
scontent-b-cdg.xx.fbcdn.net	-
scontent-b-cdt.xx.fbcdn.net	-
scontent-b-dft.xx.fbcdn.net	-
scontent-b-eze.xx.fbcdn.net	-
scontent-b-frt.xx.fbcdn.net	-
scontent-b-frx.xx.fbcdn.net	-
scontent-b-gru.xx.fbcdn.net	-
scontent-b-hkg.xx.fbcdn.net	-
scontent-b-iad.xx.fbcdn.net	-
scontent-b-icn.xx.fbcdn.net	-
scontent-b-jnb.xx.fbcdn.net	-
scontent-b-kut.xx.fbcdn.net	-
scontent-b-lax.xx.fbcdn.net	-
scontent-b-lga.xx.fbcdn.net	-
scontent-b-lhr.xx.fbcdn.net	-
scontent-b-lht.xx.fbcdn.net	-
scontent-b-mad.xx.fbcdn.net	-
scontent-b-mia.xx.fbcdn.net	-
scontent-b-mrs.xx.fbcdn.net	-
scontent-b-mxp.xx.fbcdn.net	-
scontent-b-nrt.xx.fbcdn.net	-
scontent-b-ort.xx.fbcdn.net	-
scontent-b-otp.xx.fbcdn.net	-
scontent-b-scl.xx.fbcdn.net	-
scontent-b-sea.xx.fbcdn.net	-
scontent-b-sin.xx.fbcdn.net	-
scontent-b-sit.xx.fbcdn.net	-
scontent-b-sjc.xx.fbcdn.net	-
scontent-b-sof.xx.fbcdn.net	-
scontent-b-syd.xx.fbcdn.net	-
scontent-b-tpe.xx.fbcdn.net	-
scontent-b-vie.xx.fbcdn.net	-
scontent-b-waw.xx.fbcdn.net	-
scontent-b-yyz.xx.fbcdn.net	-
static.xx.fbcdn.net	scontent.xx.fbcdn.net
video.xx.fbcdn.net	-
video-ams.xx.fbcdn.net	-
video-ams3-1.xx.fbcdn.net	-
video-amt.xx.fbcdn.net	-
video-amt2-1.xx.fbcdn.net	-
video-arn.xx.fbcdn.net	-
video-arn2-1.xx.fbcdn.net	-
video-atl.xx.fbcdn.net	-
video-atl3-1.xx.fbcdn.net	-
video-bog.xx.fbcdn.net	-
video-bog1-1.xx.fbcdn.net	-
video-bom.xx.fbcdn.net	-
video-bom1-1.xx.fbcdn.net	-
video-bru.xx.fbcdn.net	-
video-bru2-1.xx.fbcdn.net	-
video-cai.xx.fbcdn.net	-
video-cai1-1.xx.fbcdn.net	-
video-cdg.xx.fbcdn.net	-
video-cdg2-1.xx.fbcdn.net	-
video-cdt.xx.fbcdn.net	-
video-cdt1-1.xx.fbcdn.net	-
video-dft.xx.fbcdn.net	-
video-dft4-1.xx.fbcdn.net	-
video-dft4-2.xx.fbcdn.net	-
video-dft4-3.xx.fbcdn.net	-
video-eze.xx.fbcdn.net	-
video-eze1-1.xx.fbcdn.net	-
video-frt.xx.fbcdn.net	-
video-frt3-1.xx.fbcdn.net	-
video-frt3-2.xx.fbcdn.net	-
video-frx.xx.fbcdn.net	-
video-frx5-1.xx.fbcdn.net	-
video-gru.xx.fbcdn.net	-
video-gru2-1.xx.fbcdn.net	-
video-gru2-2.xx.fbcdn.net	-
video-hkg.xx.fbcdn.net	-
video-hkg3-1.xx.fbcdn.net	-
video-hkg3-2.xx.fbcdn.net	-
video-iad.xx.fbcdn.net	-
video-iad3-1.xx.fbcdn.net	-
video-icn.xx.fbcdn.net	-
video-icn1-1.xx.fbcdn.net	-
video-jnb.xx.fbcdn.net	-
video-jnb1-1.xx.fbcdn.net	-
video-kut.xx.fbcdn.net	-
video-kut2-1.xx.fbcdn.net	-
video-lax.xx.fbcdn.net	-
video-lax3-1.xx.fbcdn.net	-
video-lax3-2.xx.fbcdn.net	-
video-lga.xx.fbcdn.net	-
video-lga3-1.xx.fbcdn.net	-
video-lhr.xx.fbcdn.net	-
video-lhr3-1.xx.fbcdn.net	-
video-lht.xx.fbcdn.net	-
video-lht6-1.xx.fbcdn.net	-
video-mad.xx.fbcdn.net	-
video-mad1-1.xx.fbcdn.net	-
video-mia.xx.fbcdn.net	-
video-mia3-1.xx.fbcdn.net	-
video-mia3-2.xx.fbcdn.net	-
video-mrs.xx.fbcdn.net	-
video-mrs1-1.xx.fbcdn.net	-
video-mxp.xx.fbcdn.net	-
video-mxp1-1.xx.fbcdn.net	-
video-nrt.xx.fbcdn.net	-
video-nrt1-1.xx.fbcdn.net	-
video-ort.xx.fbcdn.net	-
video-ort2-1.xx.fbcdn.net	-
video-ort2-2.xx.fbcdn.net	-
video-otp.xx.fbcdn.net	-
video-otp1-1.xx.fbcdn.net	-
video-scl.xx.fbcdn.net	-
video-scl1-1.xx.fbcdn.net	-
video-sea.xx.fbcdn.net	-
video-sea1-1.xx.fbcdn.net	-
video-sin.xx.fbcdn.net	-
video-sin6-1.xx.fbcdn.net	-
video-sin6-2.xx.fbcdn.net	-
video-sit.xx.fbcdn.net	-
video-sit4-1.xx.fbcdn.net	-
video-sjc.xx.fbcdn.net	-
video-sjc2-1.xx.fbcdn.net	-
video-sof.xx.fbcdn.net	-
video-sof1-1.xx.fbcdn.net	-
video-syd.xx.fbcdn.net	-
video-syd2-1.xx.fbcdn.net	-
video-tpe.xx.fbcdn.net	-
video-tpe1-1.xx.fbcdn.net	-
video-vie.xx.fbcdn.net	-
video-vie1-1.xx.fbcdn.net	-
video-waw.xx.fbcdn.net	-
video-waw1-1.xx.fbcdn.net	-
video-yyz.xx.fbcdn.net	-
video-yyz1-1.xx.fbcdn.net	-
fbsbx.com	star.c10r.facebook.com
www.fbsbx.com	star.c10r.facebook.com
attachment.fbsbx.com	star.c10r.facebook.com
cdn.fbsbx.com	scontent.xx.fbcdn.net
ct-m-fbx.fbsbx.com	h-ct-m-fbx.fbsbx.com.online-metrix.net
lookaside.fbsbx.com	scontent.xx.fbcdn.net
origincache-ash.fbsbx.com	origincache-ash.t.fbcdn.net
origincache-prn.fbsbx.com	origincache-prn.t.fbcdn.net
stun.fbsbx.com	-
z-1-cdn.fbsbx.com	z-1-scontent.xx.fbcdn.net
z-1-lookaside.fbsbx.com	z-1-scontent.xx.fbcdn.net
z-m-lookaside.fbsbx.com	z-m-scontent.xx.fbcdn.net
m.me	star.c10r.facebook.com
www.m.me	star.c10r.facebook.com
messenger.com	star.c10r.facebook.com
www.messenger.com	star.c10r.facebook.com
edge-chat.messenger.com	star.c10r.facebook.com
0-edge-chat.messenger.com	star.c10r.facebook.com
1-edge-chat.messenger.com	star.c10r.facebook.com
2-edge-chat.messenger.com	star.c10r.facebook.com
3-edge-chat.messenger.com	star.c10r.facebook.com
4-edge-chat.messenger.com	star.c10r.facebook.com
5-edge-chat.messenger.com	star.c10r.facebook.com
6-edge-chat.messenger.com	star.c10r.facebook.com
apps.messenger.com	star.c10r.facebook.com
business.messenger.com	star.c10r.facebook.com
connect.messenger.com	star.c10r.facebook.com
l.messenger.com	star.c10r.facebook.com
secure.messenger.com	star.c10r.facebook.com
upload.messenger.com	star.c10r.facebook.com
af-za.messenger.com	star.c10r.facebook.com
ar-ar.messenger.com	star.c10r.facebook.com
az-az.messenger.com	star.c10r.facebook.com
be-by.messenger.com	star.c10r.facebook.com
bg-bg.messenger.com	star.c10r.facebook.com
bn-in.messenger.com	star.c10r.facebook.com
bs-ba.messenger.com	star.c10r.facebook.com
ca-es.messenger.com	star.c10r.facebook.com
cs-cz.messenger.com	star.c10r.facebook.com
cy-gb.messenger.com	star.c10r.facebook.com
da-dk.messenger.com	star.c10r.facebook.com
de-de.messenger.com	star.c10r.facebook.com
el-gr.messenger.com	star.c10r.facebook.com
en-gb.messenger.com	star.c10r.facebook.com
eo-eo.messenger.com	star.c10r.facebook.com
es-es.messenger.com	star.c10r.facebook.com
es-la.messenger.com	star.c10r.facebook.com
et-ee.messenger.com	star.c10r.facebook.com
eu-es.messenger.com	star.c10r.facebook.com
fa-ir.messenger.com	star.c10r.facebook.com
fb-lt.messenger.com	star.c10r.facebook.com
fi-fi.messenger.com	star.c10r.facebook.com
fo-fo.messenger.com	star.c10r.facebook.com
fr-ca.messenger.com	star.c10r.facebook.com
fr-fr.messenger.com	star.c10r.facebook.com
fy-nl.messenger.com	star.c10r.facebook.com
ga-ie.messenger.com	star.c10r.facebook.com
gl-es.messenger.com	star.c10r.facebook.com
he-il.messenger.com	star.c10r.facebook.com
hi-in.messenger.com	star.c10r.facebook.com
hr-hr.messenger.com	star.c10r.facebook.com
hu-hu.messenger.com	star.c10r.facebook.com
hy-am.messenger.com	star.c10r.facebook.com
id-id.messenger.com	star.c10r.facebook.com
is-is.messenger.com	star.c10r.facebook.com
it-it.messenger.com	star.c10r.facebook.com
ja-jp.messenger.com	star.c10r.facebook.com
ka-ge.messenger.com	star.c10r.facebook.com
ko-kr.messenger.com	star.c10r.facebook.com
ku-tr.messenger.com	star.c10r.facebook.com
la-va.messenger.com	star.c10r.facebook.com
lt-lt.messenger.com	star.c10r.facebook.com
lv-lv.messenger.com	star.c10r.facebook.com
mk-mk.messenger.com	star.c10r.facebook.com
ml-in.messenger.com	star.c10r.facebook.com
ms-my.messenger.com	star.c10r.facebook.com
nb-no.messenger.com	star.c10r.facebook.com
ne-np.messenger.com	star.c10r.facebook.com
nl-nl.messenger.com	star.c10r.facebook.com
nn-no.messenger.com	star.c10r.facebook.com
or-in.messenger.com	star.c10r.facebook.com
pa-in.messenger.com	star.c10r.facebook.com
pl-pl.messenger.com	star.c10r.facebook.com
ps-af.messenger.com	star.c10r.facebook.com
pt-br.messenger.com	star.c10r.facebook.com
pt-pt.messenger.com	star.c10r.facebook.com
ro-ro.messenger.com	star.c10r.facebook.com
ru-ru.messenger.com	star.c10r.facebook.com
sk-sk.messenger.com	star.c10r.facebook.com
sl-si.messenger.com	star.c10r.facebook.com
sq-al.messenger.com	star.c10r.facebook.com
sr-rs.messenger.com	star.c10r.facebook.com
sv-se.messenger.com	star.c10r.facebook.com
sw-ke.messenger.com	star.c10r.facebook.com
ta-in.messenger.com	star.c10r.facebook.com
te-in.messenger.com	star.c10r.facebook.com
th-th.messenger.com	star.c10r.facebook.com
tl-ph.messenger.com	star.c10r.facebook.com
tr-tr.messenger.com	star.c10r.facebook.com
uk-ua.messenger.com	star.c10r.facebook.com
ur-pk.messenger.com	star.c10r.facebook.com
vi-vn.messenger.com	star.c10r.facebook.com
zh-cn.messenger.com	star.c10r.facebook.com
zh-hk.messenger.com	star.c10r.facebook.com
zh-tw.messenger.com	star.c10r.facebook.com
thefacebook.com	star-mini.c10r.facebook.com
www.thefacebook.com	star-mini.c10r.facebook.com
fs.thefacebook.com	fscorp.t.tfbnw.net
accountkit.com	star.c10r.facebook.com
www.accountkit.com	star.c10r.facebook.com
graph.accountkit.com	star.c10r.facebook.com
sdk.accountkit.com	star.c10r.facebook.com
fbcdn-external-a.akamaihd.net	a1531.dsw4.akamai.net
fbcdn-gtvideo-a-a.akamaihd.net	a25.dscw22.akamai.net
fbcdn-gtvideo-b-a.akamaihd.net	a27.dscw22.akamai.net
fbcdn-gtvideo-c-a.akamaihd.net	a29.dscw22.akamai.net
fbcdn-gtvideo-d-a.akamaihd.net	a31.dscw22.akamai.net
fbcdn-gtvideo-e-a.akamaihd.net	a33.dscw27.akamai.net
fbcdn-gtvideo-f-a.akamaihd.net	a35.dscw27.akamai.net
fbcdn-gtvideo-g-a.akamaihd.net	a37.dscw27.akamai.net
fbcdn-gtvideo-h-a.akamaihd.net	a39.dscw27.akamai.net
fbcdn-gtvideo-i-a.akamaihd.net	a41.dscw28.akamai.net
fbcdn-gtvideo-j-a.akamaihd.net	a43.dscw28.akamai.net
fbcdn-gtvideo-k-a.akamaihd.net	a45.dscw28.akamai.net
fbcdn-gtvideo-l-a.akamaihd.net	a47.dscw28.akamai.net
fbcdn-gtvideo-m-a.akamaihd.net	a49.dscw29.akamai.net
fbcdn-gtvideo-n-a.akamaihd.net	a51.dscw29.akamai.net
fbcdn-gtvideo-o-a.akamaihd.net	a53.dscw29.akamai.net
fbcdn-gtvideo-p-a.akamaihd.net	a55.dscw29.akamai.net
fbcdnhdsvideo-vh.akamaihd.net	a179.w10.akamai.net
fbcdn-iphotos-a.akamaihd.net	a1001.dscw76.akamai.net
fbcdn-iphotos-a-a.akamaihd.net	a1001.dscw76.akamai.net
fbcdn-iphotos-b-a.akamaihd.net	a1402.dscw76.akamai.net
fbcdn-iphotos-c-a.akamaihd.net	a1003.dscw76.akamai.net
fbcdn-iphotos-d-a.akamaihd.net	a1404.dscw76.akamai.net
fbcdn-iphotos-e-a.akamaihd.net	a1005.dscw76.akamai.net
fbcdn-iphotos-f-a.akamaihd.net	a1406.dscw76.akamai.net
fbcdn-iphotos-g-a.akamaihd.net	a1007.dscw76.akamai.net
fbcdn-iphotos-h-a.akamaihd.net	a1408.dscw76.akamai.net
fbcdn-photos-a.akamaihd.net	a995.dspmm1.akamai.net
fbcdn-photos-a-a.akamaihd.net	a2047.dspmm1.akamai.net
fbcdn-photos-b-a.akamaihd.net	a2047.dspmm1.akamai.net
fbcdn-photos-c-a.akamaihd.net	a2047.dspmm1.akamai.net
fbcdn-photos-d-a.akamaihd.net	a2047.dspmm1.akamai.net
fbcdn-photos-e-a.akamaihd.net	a1854.dspmm1.akamai.net
fbcdn-photos-f-a.akamaihd.net	a1861.dspmm1.akamai.net
fbcdn-photos-g-a.akamaihd.net	a1906.dspmm1.akamai.net
fbcdn-photos-h-a.akamaihd.net	a1990.dspmm1.akamai.net
fbcdn-profile-a.akamaihd.net	a2047.dspl.akamai.net
fbcdn-sphotos-a.akamaihd.net	a2047.dscw76.akamai.net
fbcdn-sphotos-a-a.akamaihd.net	a2047.dscw76.akamai.net
fbcdn-sphotos-b-a.akamaihd.net	a1402.dscw76.akamai.net
fbcdn-sphotos-c-a.akamaihd.net	a2047.dscw76.akamai.net
fbcdn-sphotos-d-a.akamaihd.net	a1404.dscw76.akamai.net
fbcdn-sphotos-e-a.akamaihd.net	a2047.dscw76.akamai.net
fbcdn-sphotos-f-a.akamaihd.net	a1406.dscw76.akamai.net
fbcdn-sphotos-g-a.akamaihd.net	a2047.dscw76.akamai.net
fbcdn-sphotos-h-a.akamaihd.net	a1408.dscw76.akamai.net
fbexternal-a.akamaihd.net	a1531.dsw4.akamai.net
fb-l-a-a.akamaihd.net	a2047.dscg.akamai.net
fb-l-b-a.akamaihd.net	a2047.dscg.akamai.net
fb-l-c-a.akamaihd.net	a2047.dscg.akamai.net
fb-l-d-a.akamaihd.net	a2047.dscg.akamai.net
fblive-a.akamaihd.net	a2047.dscw80.akamai.net
fbmentionslive-a.akamaihd.net	a2047.dscw76.akamai.net
fb-s-a-a.akamaihd.net	a2047.dscg.akamai.net
fb-s-b-a.akamaihd.net	a2047.dscg.akamai.net
fb-s-c-a.akamaihd.net	a2047.dscg.akamai.net
fb-s-d-a.akamaihd.net	a2047.dscg.akamai.net
lookbackvideo1-a.akamaihd.net	a90.w22.akamai.net
lookbackvideo2-a.akamaihd.net	a1867.w27.akamai.net
lookbackvideo3-a.akamaihd.net	a1414.w28.akamai.net
lookbackvideo4-a.akamaihd.net	a610.dscw29.akamai.net
lookbackvideo5-a.akamaihd.net	a1877.w22.akamai.net
lookbackvideo6-a.akamaihd.net	a1907.w27.akamai.net
lookbackvideo7-a.akamaihd.net	a90.dscw28.akamai.net
lookbackvideo8-a.akamaihd.net	a1737.w29.akamai.net

# Flickr
flickr.com	flickr-panda-police.a00.yahoodns.net
www.flickr.com	flickr-panda-police.a00.yahoodns.net
api.flickr.com	flickr-panda-police.a00.yahoodns.net
appletv.flickr.com	appletv-production.flickr.com
auto-up.flickr.com	flickr-panda-police.a00.yahoodns.net
blog.flickr.com	rc.yahoo.com
bup.flickr.com	flickr-panda-police.a00.yahoodns.net
bup-resume.flickr.com	flickr-panda-police.a00.yahoodns.net
code.flickr.com	flickrcode.wordpress.com
csp.flickr.com	geoycpi-uno-deluxe.gycpi.b.yahoodns.net
dev.flickr.com	san3.src.yahoo.com
developer.flickr.com	san3.src.yahoo.com
downloadr.flickr.com	geoycpi-uno-deluxe.gycpi.b.yahoodns.net
downloads.flickr.com	rw.www.flickr.com
embedr.flickr.com	embedr-production.flickr.com
heartbeat.flickr.com	geoycpi-uno-deluxe.gycpi.b.yahoodns.net
hv-static.flickr.com	global-pool.static.flickr.g00.yahoodns.net
farm1.hv-static.flickr.com	global-pool.static.flickr.g00.yahoodns.net
farm2.hv-static.flickr.com	global-pool.static.flickr.g00.yahoodns.net
farm3.hv-static.flickr.com	global-pool.static.flickr.g00.yahoodns.net
farm4.hv-static.flickr.com	global-pool.static.flickr.g00.yahoodns.net
farm5.hv-static.flickr.com	global-pool.static.flickr.g00.yahoodns.net
farm6.hv-static.flickr.com	global-pool.static.flickr.g00.yahoodns.net
farm7.hv-static.flickr.com	global-pool.static.flickr.g00.yahoodns.net
farm8.hv-static.flickr.com	global-pool.static.flickr.g00.yahoodns.net
farm9.hv-static.flickr.com	global-pool.static.flickr.g00.yahoodns.net
images.flickr.com	san3.src.yahoo.com
m.flickr.com	flickr-panda-police.a00.yahoodns.net
search.flickr.com	san3.src.yahoo.com
secure.flickr.com	fts.flickr.a00.yahoodns.net
static.flickr.com	global-pool.static.flickr.g00.yahoodns.net
farm1.static.flickr.com	global-pool.static.flickr.g00.yahoodns.net
bf1.farm1.static.flickr.com	pc-pool-ngn.flickr.vip.bf1.yahoo.com
bf2.farm1.static.flickr.com	pc-pool-ngn.flickr.vip.bf1.yahoo.com
gq1.farm1.static.flickr.com	pc-pool.flickr.vip.gq1.yahoo.com
ir2.farm1.static.flickr.com	cache-eu.flickr.vip.ir2.yahoo.com
sg3.farm1.static.flickr.com	cache-ap.flickr.vip.sg3.yahoo.com
farm2.static.flickr.com	global-pool.static.flickr.g00.yahoodns.net
bf1.farm2.static.flickr.com	pc-pool-ngn.flickr.vip.bf1.yahoo.com
gq1.farm2.static.flickr.com	pc-pool.flickr.vip.gq1.yahoo.com
ir2.farm2.static.flickr.com	cache-eu.flickr.vip.ir2.yahoo.com
sg3.farm2.static.flickr.com	cache-ap.flickr.vip.sg3.yahoo.com
farm3.static.flickr.com	global-pool.static.flickr.g00.yahoodns.net
bf1.farm3.static.flickr.com	pc-pool-ngn.flickr.vip.bf1.yahoo.com
gq1.farm3.static.flickr.com	pc-pool.flickr.vip.gq1.yahoo.com
ir2.farm3.static.flickr.com	cache-eu.flickr.vip.ir2.yahoo.com
sg3.farm3.static.flickr.com	cache-ap.flickr.vip.sg3.yahoo.com
farm4.static.flickr.com	global-pool.static.flickr.g00.yahoodns.net
bf1.farm4.static.flickr.com	pc-pool-ngn.flickr.vip.bf1.yahoo.com
gq1.farm4.static.flickr.com	pc-pool.flickr.vip.gq1.yahoo.com
ir2.farm4.static.flickr.com	cache-eu.flickr.vip.ir2.yahoo.com
sg3.farm4.static.flickr.com	cache-ap.flickr.vip.sg3.yahoo.com
farm5.static.flickr.com	global-pool.static.flickr.g00.yahoodns.net
bf1.farm5.static.flickr.com	pc-pool-ngn.flickr.vip.bf1.yahoo.com
gq1.farm5.static.flickr.com	pc-pool.flickr.vip.gq1.yahoo.com
ir2.farm5.static.flickr.com	cache-eu.flickr.vip.ir2.yahoo.com
sg3.farm5.static.flickr.com	cache-ap.flickr.vip.sg3.yahoo.com
farm6.static.flickr.com	global-pool.static.flickr.g00.yahoodns.net
bf1.farm6.static.flickr.com	pc-pool-ngn.flickr.vip.bf1.yahoo.com
bf2.farm6.static.flickr.com	pc-pool-ngn.flickr.vip.bf1.yahoo.com
gq1.farm6.static.flickr.com	pc-pool.flickr.vip.gq1.yahoo.com
ir2.farm6.static.flickr.com	cache-eu.flickr.vip.ir2.yahoo.com
sg3.farm6.static.flickr.com	cache-ap.flickr.vip.sg3.yahoo.com
farm7.static.flickr.com	global-pool.static.flickr.g00.yahoodns.net
bf1.farm7.static.flickr.com	pc-pool-ngn.flickr.vip.bf1.yahoo.com
ir2.farm7.static.flickr.com	cache-eu.flickr.vip.ir2.yahoo.com
ne1.farm7.static.flickr.com	pc-pool-ngn.flickr.vip.ne1.yahoo.com
sg3.farm7.static.flickr.com	cache-ap.flickr.vip.sg3.yahoo.com
farm8.static.flickr.com	global-pool.static.flickr.g00.yahoodns.net
bf1.farm8.static.flickr.com	pc-pool-ngn.flickr.vip.bf1.yahoo.com
gq1.farm8.static.flickr.com	pc-pool.flickr.vip.gq1.yahoo.com
ir2.farm8.static.flickr.com	cache-eu.flickr.vip.ir2.yahoo.com
sg3.farm8.static.flickr.com	cache-ap.flickr.vip.sg3.yahoo.com
farm9.static.flickr.com	global-pool.static.flickr.g00.yahoodns.net
bf1.farm9.static.flickr.com	pc-pool-ngn.flickr.vip.bf1.yahoo.com
gq1.farm9.static.flickr.com	pc-pool.flickr.vip.gq1.yahoo.com
ir2.farm9.static.flickr.com	cache-eu.flickr.vip.ir2.yahoo.com
sg3.farm9.static.flickr.com	cache-ap.flickr.vip.sg3.yahoo.com
pool.static.flickr.com	global-pool.static.flickr.g00.yahoodns.net
stats.flickr.com	san3.src.yahoo.com
up.flickr.com	flickr-panda-police.a00.yahoodns.net
widgets.flickr.com	fd-geoycpi-uno-deluxe.gycpi.b.yahoodns.net
flickr.net	flickr-panda-police.a00.yahoodns.net
www.flickr.net	flickr-panda-police.a00.yahoodns.net
blog.flickr.net	flickrtheblog.wordpress.com
code.flickr.net	flickrcode.wordpress.com
c.staticflickr.com	ds-ct.gycs.b.yahoodns.net
c1.staticflickr.com	ct2.gycs.b.yahoodns.net
c2.staticflickr.com	ct2.gycs.b.yahoodns.net
c3.staticflickr.com	ct2.gycs.b.yahoodns.net
c4.staticflickr.com	ct2.gycs.b.yahoodns.net
c5.staticflickr.com	ct2.gycs.b.yahoodns.net
c6.staticflickr.com	ct2.gycs.b.yahoodns.net
c7.staticflickr.com	ct2.gycs.b.yahoodns.net
c8.staticflickr.com	ct2.gycs.b.yahoodns.net
farm1.staticflickr.com	global-pool.static.flickr.g00.yahoodns.net
bf1.farm1.staticflickr.com	pc-pool-ngn.flickr.vip.bf1.yahoo.com
bf2.farm1.staticflickr.com	pc-pool-ngn.flickr.vip.bf1.yahoo.com
gq1.farm1.staticflickr.com	pc-pool.flickr.vip.gq1.yahoo.com
ir2.farm1.staticflickr.com	cache-eu.flickr.vip.ir2.yahoo.com
sg3.farm1.staticflickr.com	cache-ap.flickr.vip.sg3.yahoo.com
a.farm1.staticflickr.com	global-pool.static.flickr.g00.yahoodns.net
b.farm1.staticflickr.com	global-pool.static.flickr.g00.yahoodns.net
c.farm1.staticflickr.com	global-pool.static.flickr.g00.yahoodns.net
d.farm1.staticflickr.com	global-pool.static.flickr.g00.yahoodns.net
e.farm1.staticflickr.com	global-pool.static.flickr.g00.yahoodns.net
f.farm1.staticflickr.com	global-pool.static.flickr.g00.yahoodns.net
farm2.staticflickr.com	global-pool.static.flickr.g00.yahoodns.net
bf1.farm2.staticflickr.com	pc-pool-ngn.flickr.vip.bf1.yahoo.com
gq1.farm2.staticflickr.com	pc-pool.flickr.vip.gq1.yahoo.com
ir2.farm2.staticflickr.com	cache-eu.flickr.vip.ir2.yahoo.com
sg3.farm2.staticflickr.com	cache-ap.flickr.vip.sg3.yahoo.com
a.farm2.staticflickr.com	global-pool.static.flickr.g00.yahoodns.net
b.farm2.staticflickr.com	global-pool.static.flickr.g00.yahoodns.net
c.farm2.staticflickr.com	global-pool.static.flickr.g00.yahoodns.net
d.farm2.staticflickr.com	global-pool.static.flickr.g00.yahoodns.net
e.farm2.staticflickr.com	global-pool.static.flickr.g00.yahoodns.net
f.farm2.staticflickr.com	global-pool.static.flickr.g00.yahoodns.net
farm3.staticflickr.com	global-pool.static.flickr.g00.yahoodns.net
bf1.farm3.staticflickr.com	pc-pool-ngn.flickr.vip.bf1.yahoo.com
gq1.farm3.staticflickr.com	pc-pool.flickr.vip.gq1.yahoo.com
ir2.farm3.staticflickr.com	cache-eu.flickr.vip.ir2.yahoo.com
sg3.farm3.staticflickr.com	cache-ap.flickr.vip.sg3.yahoo.com
a.farm3.staticflickr.com	global-pool.static.flickr.g00.yahoodns.net
b.farm3.staticflickr.com	global-pool.static.flickr.g00.yahoodns.net
c.farm3.staticflickr.com	global-pool.static.flickr.g00.yahoodns.net
d.farm3.staticflickr.com	global-pool.static.flickr.g00.yahoodns.net
e.farm3.staticflickr.com	global-pool.static.flickr.g00.yahoodns.net
f.farm3.staticflickr.com	global-pool.static.flickr.g00.yahoodns.net
farm4.staticflickr.com	global-pool.static.flickr.g00.yahoodns.net
bf1.farm4.staticflickr.com	pc-pool-ngn.flickr.vip.bf1.yahoo.com
gq1.farm4.staticflickr.com	pc-pool.flickr.vip.gq1.yahoo.com
ir2.farm4.staticflickr.com	cache-eu.flickr.vip.ir2.yahoo.com
sg3.farm4.staticflickr.com	cache-ap.flickr.vip.sg3.yahoo.com
a.farm4.staticflickr.com	global-pool.static.flickr.g00.yahoodns.net
b.farm4.staticflickr.com	global-pool.static.flickr.g00.yahoodns.net
c.farm4.staticflickr.com	global-pool.static.flickr.g00.yahoodns.net
d.farm4.staticflickr.com	global-pool.static.flickr.g00.yahoodns.net
e.farm4.staticflickr.com	global-pool.static.flickr.g00.yahoodns.net
f.farm4.staticflickr.com	global-pool.static.flickr.g00.yahoodns.net
farm5.staticflickr.com	global-pool.static.flickr.g00.yahoodns.net
bf1.farm5.staticflickr.com	pc-pool-ngn.flickr.vip.bf1.yahoo.com
gq1.farm5.staticflickr.com	pc-pool.flickr.vip.gq1.yahoo.com
ir2.farm5.staticflickr.com	cache-eu.flickr.vip.ir2.yahoo.com
sg3.farm5.staticflickr.com	cache-ap.flickr.vip.sg3.yahoo.com
a.farm5.staticflickr.com	global-pool.static.flickr.g00.yahoodns.net
b.farm5.staticflickr.com	global-pool.static.flickr.g00.yahoodns.net
c.farm5.staticflickr.com	global-pool.static.flickr.g00.yahoodns.net
d.farm5.staticflickr.com	global-pool.static.flickr.g00.yahoodns.net
e.farm5.staticflickr.com	global-pool.static.flickr.g00.yahoodns.net
f.farm5.staticflickr.com	global-pool.static.flickr.g00.yahoodns.net
farm6.staticflickr.com	global-pool.static.flickr.g00.yahoodns.net
bf1.farm6.staticflickr.com	pc-pool-ngn.flickr.vip.bf1.yahoo.com
bf2.farm6.staticflickr.com	pc-pool-ngn.flickr.vip.bf1.yahoo.com
gq1.farm6.staticflickr.com	pc-pool.flickr.vip.gq1.yahoo.com
ir2.farm6.staticflickr.com	cache-eu.flickr.vip.ir2.yahoo.com
sg3.farm6.staticflickr.com	cache-ap.flickr.vip.sg3.yahoo.com
a.farm6.staticflickr.com	global-pool.static.flickr.g00.yahoodns.net
b.farm6.staticflickr.com	global-pool.static.flickr.g00.yahoodns.net
c.farm6.staticflickr.com	global-pool.static.flickr.g00.yahoodns.net
d.farm6.staticflickr.com	global-pool.static.flickr.g00.yahoodns.net
e.farm6.staticflickr.com	global-pool.static.flickr.g00.yahoodns.net
f.farm6.staticflickr.com	global-pool.static.flickr.g00.yahoodns.net
farm7.staticflickr.com	global-pool.static.flickr.g00.yahoodns.net
bf1.farm7.staticflickr.com	pc-pool-ngn.flickr.vip.bf1.yahoo.com
gq1.farm7.staticflickr.com	pc-pool.flickr.vip.gq1.yahoo.com
ir2.farm7.staticflickr.com	cache-eu.flickr.vip.ir2.yahoo.com
ne1.farm7.staticflickr.com	pc-pool-ngn.flickr.vip.ne1.yahoo.com
sg3.farm7.staticflickr.com	cache-ap.flickr.vip.sg3.yahoo.com
a.farm7.staticflickr.com	global-pool.static.flickr.g00.yahoodns.net
b.farm7.staticflickr.com	global-pool.static.flickr.g00.yahoodns.net
c.farm7.staticflickr.com	global-pool.static.flickr.g00.yahoodns.net
d.farm7.staticflickr.com	global-pool.static.flickr.g00.yahoodns.net
e.farm7.staticflickr.com	global-pool.static.flickr.g00.yahoodns.net
f.farm7.staticflickr.com	global-pool.static.flickr.g00.yahoodns.net
farm8.staticflickr.com	global-pool.static.flickr.g00.yahoodns.net
bf1.farm8.staticflickr.com	pc-pool-ngn.flickr.vip.bf1.yahoo.com
gq1.farm8.staticflickr.com	pc-pool.flickr.vip.gq1.yahoo.com
ir2.farm8.staticflickr.com	cache-eu.flickr.vip.ir2.yahoo.com
sg3.farm8.staticflickr.com	cache-ap.flickr.vip.sg3.yahoo.com
a.farm8.staticflickr.com	global-pool.static.flickr.g00.yahoodns.net
b.farm8.staticflickr.com	global-pool.static.flickr.g00.yahoodns.net
c.farm8.staticflickr.com	global-pool.static.flickr.g00.yahoodns.net
d.farm8.staticflickr.com	global-pool.static.flickr.g00.yahoodns.net
e.farm8.staticflickr.com	global-pool.static.flickr.g00.yahoodns.net
f.farm8.staticflickr.com	global-pool.static.flickr.g00.yahoodns.net
farm9.staticflickr.com	global-pool.static.flickr.g00.yahoodns.net
bf1.farm9.staticflickr.com	pc-pool-ngn.flickr.vip.bf1.yahoo.com
gq1.farm9.staticflickr.com	pc-pool.flickr.vip.gq1.yahoo.com
ir2.farm9.staticflickr.com	cache-eu.flickr.vip.ir2.yahoo.com
sg3.farm9.staticflickr.com	cache-ap.flickr.vip.sg3.yahoo.com
a.farm9.staticflickr.com	global-pool.static.flickr.g00.yahoodns.net
b.farm9.staticflickr.com	global-pool.static.flickr.g00.yahoodns.net
c.farm9.staticflickr.com	global-pool.static.flickr.g00.yahoodns.net
d.farm9.staticflickr.com	global-pool.static.flickr.g00.yahoodns.net
e.farm9.staticflickr.com	global-pool.static.flickr.g00.yahoodns.net
f.farm9.staticflickr.com	global-pool.static.flickr.g00.yahoodns.net
p1.staticflickr.com	ct2.gycs.b.yahoodns.net
p2.staticflickr.com	ct2.gycs.b.yahoodns.net
p3.staticflickr.com	ct2.gycs.b.yahoodns.net
p4.staticflickr.com	ct2.gycs.b.yahoodns.net
p5.staticflickr.com	ct2.gycs.b.yahoodns.net
p6.staticflickr.com	ct2.gycs.b.yahoodns.net
p7.staticflickr.com	ct2.gycs.b.yahoodns.net
p8.staticflickr.com	ct2.gycs.b.yahoodns.net

# Instagram
instagram.com	z-p42-instagram.c10r.facebook.com
www.instagram.com	z-p42-instagram.c10r.facebook.com
images.ak.instagram.com	a1404.dscw76.akamai.net
static.ak.instagram.com	a749.dsw4.akamai.net
api.instagram.com	instagram.c10r.facebook.com
badges.instagram.com	instagram.c10r.facebook.com
blog.instagram.com	star.c10r.facebook.com
graph.instagram.com	instagram.c10r.facebook.com
help.instagram.com	instagram.c10r.facebook.com
i.instagram.com	instagram.c10r.facebook.com
l.instagram.com	instagram.c10r.facebook.com
logger.instagram.com	instagram.c10r.facebook.com
maps.instagram.com	instagram.c10r.facebook.com
platform.instagram.com	instagram.c10r.facebook.com
external.cdninstagram.com	scontent.cdninstagram.com
scontent.cdninstagram.com	scontent.cdninstagram.com
scontent-ams.cdninstagram.com	-
scontent-ams3-1.cdninstagram.com	-
scontent-amt.cdninstagram.com	-
scontent-amt2-1.cdninstagram.com	-
scontent-arn.cdninstagram.com	-
scontent-arn2-1.cdninstagram.com	-
scontent-atl.cdninstagram.com	-
scontent-atl3-1.cdninstagram.com	-
scontent-bog.cdninstagram.com	-
scontent-bog1-1.cdninstagram.com	-
scontent-bom.cdninstagram.com	-
scontent-bom1-1.cdninstagram.com	-
scontent-bru.cdninstagram.com	-
scontent-bru2-1.cdninstagram.com	-
scontent-cai.cdninstagram.com	-
scontent-cai1-1.cdninstagram.com	-
scontent-cdg.cdninstagram.com	-
scontent-cdg2-1.cdninstagram.com	-
scontent-cdt.cdninstagram.com	-
scontent-cdt1-1.cdninstagram.com	-
scontent-eze.cdninstagram.com	-
scontent-eze1-1.cdninstagram.com	-
scontent-frt.cdninstagram.com	-
scontent-frt3-1.cdninstagram.com	-
scontent-frt3-2.cdninstagram.com	-
scontent-frx.cdninstagram.com	-
scontent-frx5-1.cdninstagram.com	-
scontent-gru.cdninstagram.com	-
scontent-gru2-1.cdninstagram.com	-
scontent-gru2-2.cdninstagram.com	-
scontent-hkg.cdninstagram.com	-
scontent-hkg3-1.cdninstagram.com	-
scontent-hkg3-2.cdninstagram.com	-
scontent-iad.cdninstagram.com	-
scontent-iad3-1.cdninstagram.com	-
scontent-icn.cdninstagram.com	-
scontent-icn1-1.cdninstagram.com	-
scontent-jnb.cdninstagram.com	-
scontent-jnb1-1.cdninstagram.com	-
scontent-kut.cdninstagram.com	-
scontent-kut2-1.cdninstagram.com	-
scontent-lax.cdninstagram.com	-
scontent-lax3-1.cdninstagram.com	-
scontent-lax3-2.cdninstagram.com	-
scontent-lga.cdninstagram.com	-
scontent-lga3-1.cdninstagram.com	-
scontent-lhr.cdninstagram.com	-
scontent-lhr3-1.cdninstagram.com	-
scontent-lht.cdninstagram.com	-
scontent-lht6-1.cdninstagram.com	-
scontent-mad.cdninstagram.com	-
scontent-mad1-1.cdninstagram.com	-
scontent-mia.cdninstagram.com	-
scontent-mia3-1.cdninstagram.com	-
scontent-mia3-2.cdninstagram.com	-
scontent-mrs.cdninstagram.com	-
scontent-mrs1-1.cdninstagram.com	-
scontent-mxp.cdninstagram.com	-
scontent-mxp1-1.cdninstagram.com	-
scontent-nrt.cdninstagram.com	-
scontent-nrt1-1.cdninstagram.com	-
scontent-ort.cdninstagram.com	-
scontent-ort2-1.cdninstagram.com	-
scontent-ort2-2.cdninstagram.com	-
scontent-otp.cdninstagram.com	-
scontent-otp1-1.cdninstagram.com	-
scontent-scl.cdninstagram.com	-
scontent-scl1-1.cdninstagram.com	-
scontent-sea.cdninstagram.com	-
scontent-sea1-1.cdninstagram.com	-
scontent-sin.cdninstagram.com	-
scontent-sin6-1.cdninstagram.com	-
scontent-sin6-2.cdninstagram.com	-
scontent-sjc.cdninstagram.com	-
scontent-sof.cdninstagram.com	-
scontent-sof1-1.cdninstagram.com	-
scontent-syd.cdninstagram.com	-
scontent-syd2-1.cdninstagram.com	-
scontent-tpe.cdninstagram.com	-
scontent-tpe1-1.cdninstagram.com	-
scontent-vie.cdninstagram.com	-
scontent-vie1-1.cdninstagram.com	-
scontent-waw.cdninstagram.com	-
scontent-waw1-1.cdninstagram.com	-
scontent-yyz.cdninstagram.com	-
scontent-yyz1-1.cdninstagram.com	-
scontent-a.cdninstagram.com	scontent.cdninstagram.com
scontent-a-ams.cdninstagram.com	-
scontent-a-ams3-1.cdninstagram.com	-
scontent-a-amt.cdninstagram.com	-
scontent-a-amt2-1.cdninstagram.com	-
scontent-a-arn.cdninstagram.com	-
scontent-a-arn2-1.cdninstagram.com	-
scontent-a-atl.cdninstagram.com	-
scontent-a-atl3-1.cdninstagram.com	-
scontent-a-bog.cdninstagram.com	-
scontent-a-bog1-1.cdninstagram.com	-
scontent-a-bom.cdninstagram.com	-
scontent-a-bom1-1.cdninstagram.com	-
scontent-a-bru.cdninstagram.com	-
scontent-a-bru2-1.cdninstagram.com	-
scontent-a-cai.cdninstagram.com	-
scontent-a-cai1-1.cdninstagram.com	-
scontent-a-cdg.cdninstagram.com	-
scontent-a-cdg2-1.cdninstagram.com	-
scontent-a-cdt.cdninstagram.com	-
scontent-a-cdt1-1.cdninstagram.com	-
scontent-a-eze.cdninstagram.com	-
scontent-a-eze1-1.cdninstagram.com	-
scontent-a-frt.cdninstagram.com	-
scontent-a-frt3-1.cdninstagram.com	-
scontent-a-frt3-2.cdninstagram.com	-
scontent-a-frx.cdninstagram.com	-
scontent-a-frx5-1.cdninstagram.com	-
scontent-a-gru.cdninstagram.com	-
scontent-a-gru2-1.cdninstagram.com	-
scontent-a-gru2-2.cdninstagram.com	-
scontent-a-hkg.cdninstagram.com	-
scontent-a-hkg3-1.cdninstagram.com	-
scontent-a-hkg3-2.cdninstagram.com	-
scontent-a-iad.cdninstagram.com	-
scontent-a-iad3-1.cdninstagram.com	-
scontent-a-icn.cdninstagram.com	-
scontent-a-icn1-1.cdninstagram.com	-
scontent-a-jnb.cdninstagram.com	-
scontent-a-jnb1-1.cdninstagram.com	-
scontent-a-kut.cdninstagram.com	-
scontent-a-kut2-1.cdninstagram.com	-
scontent-a-lax.cdninstagram.com	-
scontent-a-lax3-1.cdninstagram.com	-
scontent-a-lax3-2.cdninstagram.com	-
scontent-a-lga.cdninstagram.com	-
scontent-a-lga3-1.cdninstagram.com	-
scontent-a-lhr.cdninstagram.com	-
scontent-a-lhr3-1.cdninstagram.com	-
scontent-a-lht.cdninstagram.com	-
scontent-a-lht6-1.cdninstagram.com	-
scontent-a-mad.cdninstagram.com	-
scontent-a-mad1-1.cdninstagram.com	-
scontent-a-mia.cdninstagram.com	-
scontent-a-mia3-1.cdninstagram.com	-
scontent-a-mia3-2.cdninstagram.com	-
scontent-a-mrs.cdninstagram.com	-
scontent-a-mrs1-1.cdninstagram.com	-
scontent-a-mxp.cdninstagram.com	-
scontent-a-mxp1-1.cdninstagram.com	-
scontent-a-nrt.cdninstagram.com	-
scontent-a-nrt1-1.cdninstagram.com	-
scontent-a-ort.cdninstagram.com	-
scontent-a-ort2-1.cdninstagram.com	-
scontent-a-ort2-2.cdninstagram.com	-
scontent-a-otp.cdninstagram.com	-
scontent-a-otp1-1.cdninstagram.com	-
scontent-a-scl.cdninstagram.com	-
scontent-a-scl1-1.cdninstagram.com	-
scontent-a-sea.cdninstagram.com	-
scontent-a-sea1-1.cdninstagram.com	-
scontent-a-sin.cdninstagram.com	-
scontent-a-sin6-1.cdninstagram.com	-
scontent-a-sin6-2.cdninstagram.com	-
scontent-a-sjc.cdninstagram.com	-
scontent-a-sof.cdninstagram.com	-
scontent-a-sof1-1.cdninstagram.com	-
scontent-a-syd.cdninstagram.com	-
scontent-a-syd2-1.cdninstagram.com	-
scontent-a-tpe.cdninstagram.com	-
scontent-a-tpe1-1.cdninstagram.com	-
scontent-a-vie.cdninstagram.com	-
scontent-a-vie1-1.cdninstagram.com	-
scontent-a-waw.cdninstagram.com	-
scontent-a-waw1-1.cdninstagram.com	-
scontent-a-yyz.cdninstagram.com	-
scontent-a-yyz1-1.cdninstagram.com	-
scontent-b.cdninstagram.com	scontent.cdninstagram.com
scontent-b-ams.cdninstagram.com	-
scontent-b-ams3-1.cdninstagram.com	-
scontent-b-amt.cdninstagram.com	-
scontent-b-amt2-1.cdninstagram.com	-
scontent-b-arn.cdninstagram.com	-
scontent-b-arn2-1.cdninstagram.com	-
scontent-b-atl.cdninstagram.com	-
scontent-b-atl3-1.cdninstagram.com	-
scontent-b-bog.cdninstagram.com	-
scontent-b-bog1-1.cdninstagram.com	-
scontent-b-bom.cdninstagram.com	-
scontent-b-bom1-1.cdninstagram.com	-
scontent-b-bru.cdninstagram.com	-
scontent-b-bru2-1.cdninstagram.com	-
scontent-b-cai.cdninstagram.com	-
scontent-b-cai1-1.cdninstagram.com	-
scontent-b-cdg.cdninstagram.com	-
scontent-b-cdg2-1.cdninstagram.com	-
scontent-b-cdt.cdninstagram.com	-
scontent-b-cdt1-1.cdninstagram.com	-
scontent-b-eze.cdninstagram.com	-
scontent-b-eze1-1.cdninstagram.com	-
scontent-b-frt.cdninstagram.com	-
scontent-b-frt3-1.cdninstagram.com	-
scontent-b-frt3-2.cdninstagram.com	-
scontent-b-frx.cdninstagram.com	-
scontent-b-frx5-1.cdninstagram.com	-
scontent-b-gru.cdninstagram.com	-
scontent-b-gru2-1.cdninstagram.com	-
scontent-b-gru2-2.cdninstagram.com	-
scontent-b-hkg.cdninstagram.com	-
scontent-b-hkg3-1.cdninstagram.com	-
scontent-b-hkg3-2.cdninstagram.com	-
scontent-b-iad.cdninstagram.com	-
scontent-b-iad3-1.cdninstagram.com	-
scontent-b-icn.cdninstagram.com	-
scontent-b-icn1-1.cdninstagram.com	-
scontent-b-jnb.cdninstagram.com	-
scontent-b-jnb1-1.cdninstagram.com	-
scontent-b-kut.cdninstagram.com	-
scontent-b-kut2-1.cdninstagram.com	-
scontent-b-lax.cdninstagram.com	-
scontent-b-lax3-1.cdninstagram.com	-
scontent-b-lax3-2.cdninstagram.com	-
scontent-b-lga.cdninstagram.com	-
scontent-b-lga3-1.cdninstagram.com	-
scontent-b-lhr.cdninstagram.com	-
scontent-b-lhr3-1.cdninstagram.com	-
scontent-b-lht.cdninstagram.com	-
scontent-b-lht6-1.cdninstagram.com	-
scontent-b-mad.cdninstagram.com	-
scontent-b-mad1-1.cdninstagram.com	-
scontent-b-mia.cdninstagram.com	-
scontent-b-mia3-1.cdninstagram.com	-
scontent-b-mia3-2.cdninstagram.com	-
scontent-b-mrs.cdninstagram.com	-
scontent-b-mrs1-1.cdninstagram.com	-
scontent-b-mxp.cdninstagram.com	-
scontent-b-mxp1-1.cdninstagram.com	-
scontent-b-nrt.cdninstagram.com	-
scontent-b-nrt1-1.cdninstagram.com	-
scontent-b-ort.cdninstagram.com	-
scontent-b-ort2-1.cdninstagram.com	-
scontent-b-ort2-2.cdninstagram.com	-
scontent-b-otp.cdninstagram.com	-
scontent-b-otp1-1.cdninstagram.com	-
scontent-b-scl.cdninstagram.com	-
scontent-b-scl1-1.cdninstagram.com	-
scontent-b-sea.cdninstagram.com	-
scontent-b-sea1-1.cdninstagram.com	-
scontent-b-sin.cdninstagram.com	-
scontent-b-sin6-1.cdninstagram.com	-
scontent-b-sin6-2.cdninstagram.com	-
scontent-b-sjc.cdninstagram.com	-
scontent-b-sof.cdninstagram.com	-
scontent-b-sof1-1.cdninstagram.com	-
scontent-b-syd.cdninstagram.com	-
scontent-b-syd2-1.cdninstagram.com	-
scontent-b-tpe.cdninstagram.com	-
scontent-b-tpe1-1.cdninstagram.com	-
scontent-b-vie.cdninstagram.com	-
scontent-b-vie1-1.cdninstagram.com	-
scontent-b-waw.cdninstagram.com	-
scontent-b-waw1-1.cdninstagram.com	-
scontent-b-yyz.cdninstagram.com	-
scontent-b-yyz1-1.cdninstagram.com	-
static.cdninstagram.com	scontent.cdninstagram.com
igcdnhdsvideo-vh.akamaihd.net	a15.w10.akamai.net
igcdn-photos-a-a.akamaihd.net	a1001.dscw76.akamai.net
igcdn-photos-b-a.akamaihd.net	a1402.dscw76.akamai.net
igcdn-photos-c-a.akamaihd.net	a1003.dscw76.akamai.net
igcdn-photos-d-a.akamaihd.net	a1404.dscw76.akamai.net
igcdn-photos-e-a.akamaihd.net	a1005.dscw76.akamai.net
igcdn-photos-f-a.akamaihd.net	a1406.dscw76.akamai.net
igcdn-photos-g-a.akamaihd.net	a1007.dscw76.akamai.net
igcdn-photos-h-a.akamaihd.net	a1408.dscw76.akamai.net
igcdn-videos-a-0-a.akamaihd.net	a30.dscw81.akamai.net
igcdn-videos-a-1-a.akamaihd.net	a38.dscw81.akamai.net
igcdn-videos-a-2-a.akamaihd.net	a46.dscw81.akamai.net
igcdn-videos-a-3-a.akamaihd.net	a54.dscw81.akamai.net
igcdn-videos-a-4-a.akamaihd.net	a62.dscw81.akamai.net
igcdn-videos-a-5-a.akamaihd.net	a70.dscw81.akamai.net
igcdn-videos-a-6-a.akamaihd.net	a78.dscw81.akamai.net
igcdn-videos-a-7-a.akamaihd.net	a86.dscw81.akamai.net
igcdn-videos-a-8-a.akamaihd.net	a94.dscw81.akamai.net
igcdn-videos-a-9-a.akamaihd.net	a102.dscw81.akamai.net
igcdn-videos-a-10-a.akamaihd.net	a110.dscw81.akamai.net
igcdn-videos-a-11-a.akamaihd.net	a118.dscw81.akamai.net
igcdn-videos-a-12-a.akamaihd.net	a126.dscw81.akamai.net
igcdn-videos-a-13-a.akamaihd.net	a134.dscw81.akamai.net
igcdn-videos-a-14-a.akamaihd.net	a142.dscw81.akamai.net
igcdn-videos-a-15-a.akamaihd.net	a150.dscw81.akamai.net
igcdn-videos-a-16-a.akamaihd.net	a158.dscw81.akamai.net
igcdn-videos-a-17-a.akamaihd.net	a166.dscw81.akamai.net
igcdn-videos-a-18-a.akamaihd.net	a174.dscw81.akamai.net
igcdn-videos-a-19-a.akamaihd.net	a182.dscw81.akamai.net
igcdn-videos-b-0-a.akamaihd.net	a31.dscw81.akamai.net
igcdn-videos-b-1-a.akamaihd.net	a39.dscw81.akamai.net
igcdn-videos-b-2-a.akamaihd.net	a47.dscw81.akamai.net
igcdn-videos-b-3-a.akamaihd.net	a55.dscw81.akamai.net
igcdn-videos-b-4-a.akamaihd.net	a63.dscw81.akamai.net
igcdn-videos-b-5-a.akamaihd.net	a71.dscw81.akamai.net
igcdn-videos-b-6-a.akamaihd.net	a79.dscw81.akamai.net
igcdn-videos-b-7-a.akamaihd.net	a87.dscw81.akamai.net
igcdn-videos-b-8-a.akamaihd.net	a95.dscw81.akamai.net
igcdn-videos-b-9-a.akamaihd.net	a103.dscw81.akamai.net
igcdn-videos-b-10-a.akamaihd.net	a111.dscw81.akamai.net
igcdn-videos-b-11-a.akamaihd.net	a119.dscw81.akamai.net
igcdn-videos-b-12-a.akamaihd.net	a127.dscw81.akamai.net
igcdn-videos-b-13-a.akamaihd.net	a135.dscw81.akamai.net
igcdn-videos-b-14-a.akamaihd.net	a143.dscw81.akamai.net
igcdn-videos-b-15-a.akamaihd.net	a151.dscw81.akamai.net
igcdn-videos-b-16-a.akamaihd.net	a159.dscw81.akamai.net
igcdn-videos-b-17-a.akamaihd.net	a167.dscw81.akamai.net
igcdn-videos-b-18-a.akamaihd.net	a175.dscw81.akamai.net
igcdn-videos-b-19-a.akamaihd.net	a183.dscw81.akamai.net
igcdn-videos-c-0-a.akamaihd.net	a32.dscw81.akamai.net
igcdn-videos-c-1-a.akamaihd.net	a40.dscw81.akamai.net
igcdn-videos-c-2-a.akamaihd.net	a48.dscw81.akamai.net
igcdn-videos-c-3-a.akamaihd.net	a56.dscw81.akamai.net
igcdn-videos-c-4-a.akamaihd.net	a64.dscw81.akamai.net
igcdn-videos-c-5-a.akamaihd.net	a72.dscw81.akamai.net
igcdn-videos-c-6-a.akamaihd.net	a80.dscw81.akamai.net
igcdn-videos-c-7-a.akamaihd.net	a88.dscw81.akamai.net
igcdn-videos-c-8-a.akamaihd.net	a96.dscw81.akamai.net
igcdn-videos-c-9-a.akamaihd.net	a104.dscw81.akamai.net
igcdn-videos-c-10-a.akamaihd.net	a112.dscw81.akamai.net
igcdn-videos-c-11-a.akamaihd.net	a120.dscw81.akamai.net
igcdn-videos-c-12-a.akamaihd.net	a128.dscw81.akamai.net
igcdn-videos-c-13-a.akamaihd.net	a136.dscw81.akamai.net
igcdn-videos-c-14-a.akamaihd.net	a144.dscw81.akamai.net
igcdn-videos-c-15-a.akamaihd.net	a152.dscw81.akamai.net
igcdn-videos-c-16-a.akamaihd.net	a160.dscw81.akamai.net
igcdn-videos-c-17-a.akamaihd.net	a168.dscw81.akamai.net
igcdn-videos-c-18-a.akamaihd.net	a176.dscw81.akamai.net
igcdn-videos-c-19-a.akamaihd.net	a184.dscw81.akamai.net
igcdn-videos-d-0-a.akamaihd.net	a33.dscw81.akamai.net
igcdn-videos-d-1-a.akamaihd.net	a41.dscw81.akamai.net
igcdn-videos-d-2-a.akamaihd.net	a49.dscw81.akamai.net
igcdn-videos-d-3-a.akamaihd.net	a57.dscw81.akamai.net
igcdn-videos-d-4-a.akamaihd.net	a65.dscw81.akamai.net
igcdn-videos-d-5-a.akamaihd.net	a73.dscw81.akamai.net
igcdn-videos-d-6-a.akamaihd.net	a81.dscw81.akamai.net
igcdn-videos-d-7-a.akamaihd.net	a89.dscw81.akamai.net
igcdn-videos-d-8-a.akamaihd.net	a97.dscw81.akamai.net
igcdn-videos-d-9-a.akamaihd.net	a105.dscw81.akamai.net
igcdn-videos-d-10-a.akamaihd.net	a113.dscw81.akamai.net
igcdn-videos-d-11-a.akamaihd.net	a121.dscw81.akamai.net
igcdn-videos-d-12-a.akamaihd.net	a129.dscw81.akamai.net
igcdn-videos-d-13-a.akamaihd.net	a137.dscw81.akamai.net
igcdn-videos-d-14-a.akamaihd.net	a145.dscw81.akamai.net
igcdn-videos-d-15-a.akamaihd.net	a153.dscw81.akamai.net
igcdn-videos-d-16-a.akamaihd.net	a161.dscw81.akamai.net
igcdn-videos-d-17-a.akamaihd.net	a169.dscw81.akamai.net
igcdn-videos-d-18-a.akamaihd.net	a177.dscw81.akamai.net
igcdn-videos-d-19-a.akamaihd.net	a185.dscw81.akamai.net
igcdn-videos-e-0-a.akamaihd.net	a34.dscw81.akamai.net
igcdn-videos-e-1-a.akamaihd.net	a42.dscw81.akamai.net
igcdn-videos-e-2-a.akamaihd.net	a50.dscw81.akamai.net
igcdn-videos-e-3-a.akamaihd.net	a58.dscw81.akamai.net
igcdn-videos-e-4-a.akamaihd.net	a66.dscw81.akamai.net
igcdn-videos-e-5-a.akamaihd.net	a74.dscw81.akamai.net
igcdn-videos-e-6-a.akamaihd.net	a82.dscw81.akamai.net
igcdn-videos-e-7-a.akamaihd.net	a90.dscw81.akamai.net
igcdn-videos-e-8-a.akamaihd.net	a98.dscw81.akamai.net
igcdn-videos-e-9-a.akamaihd.net	a106.dscw81.akamai.net
igcdn-videos-e-10-a.akamaihd.net	a114.dscw81.akamai.net
igcdn-videos-e-11-a.akamaihd.net	a122.dscw81.akamai.net
igcdn-videos-e-12-a.akamaihd.net	a130.dscw81.akamai.net
igcdn-videos-e-13-a.akamaihd.net	a138.dscw81.akamai.net
igcdn-videos-e-14-a.akamaihd.net	a146.dscw81.akamai.net
igcdn-videos-e-15-a.akamaihd.net	a154.dscw81.akamai.net
igcdn-videos-e-16-a.akamaihd.net	a162.dscw81.akamai.net
igcdn-videos-e-17-a.akamaihd.net	a170.dscw81.akamai.net
igcdn-videos-e-18-a.akamaihd.net	a178.dscw81.akamai.net
igcdn-videos-e-19-a.akamaihd.net	a186.dscw81.akamai.net
igcdn-videos-f-0-a.akamaihd.net	a35.dscw81.akamai.net
igcdn-videos-f-1-a.akamaihd.net	a43.dscw81.akamai.net
igcdn-videos-f-2-a.akamaihd.net	a51.dscw81.akamai.net
igcdn-videos-f-3-a.akamaihd.net	a59.dscw81.akamai.net
igcdn-videos-f-4-a.akamaihd.net	a67.dscw81.akamai.net
igcdn-videos-f-5-a.akamaihd.net	a75.dscw81.akamai.net
igcdn-videos-f-6-a.akamaihd.net	a83.dscw81.akamai.net
igcdn-videos-f-7-a.akamaihd.net	a91.dscw81.akamai.net
igcdn-videos-f-8-a.akamaihd.net	a99.dscw81.akamai.net
igcdn-videos-f-9-a.akamaihd.net	a107.dscw81.akamai.net
igcdn-videos-f-10-a.akamaihd.net	a115.dscw81.akamai.net
igcdn-videos-f-11-a.akamaihd.net	a123.dscw81.akamai.net
igcdn-videos-f-12-a.akamaihd.net	a131.dscw81.akamai.net
igcdn-videos-f-13-a.akamaihd.net	a139.dscw81.akamai.net
igcdn-videos-f-14-a.akamaihd.net	a147.dscw81.akamai.net
igcdn-videos-f-15-a.akamaihd.net	a155.dscw81.akamai.net
igcdn-videos-f-16-a.akamaihd.net	a163.dscw81.akamai.net
igcdn-videos-f-17-a.akamaihd.net	a171.dscw81.akamai.net
igcdn-videos-f-18-a.akamaihd.net	a179.dscw81.akamai.net
igcdn-videos-f-19-a.akamaihd.net	a187.dscw81.akamai.net
igcdn-videos-g-0-a.akamaihd.net	a36.dscw81.akamai.net
igcdn-videos-g-1-a.akamaihd.net	a44.dscw81.akamai.net
igcdn-videos-g-2-a.akamaihd.net	a52.dscw81.akamai.net
igcdn-videos-g-3-a.akamaihd.net	a60.dscw81.akamai.net
igcdn-videos-g-4-a.akamaihd.net	a68.dscw81.akamai.net
igcdn-videos-g-5-a.akamaihd.net	a76.dscw81.akamai.net
igcdn-videos-g-6-a.akamaihd.net	a84.dscw81.akamai.net
igcdn-videos-g-7-a.akamaihd.net	a92.dscw81.akamai.net
igcdn-videos-g-8-a.akamaihd.net	a100.dscw81.akamai.net
igcdn-videos-g-9-a.akamaihd.net	a108.dscw81.akamai.net
igcdn-videos-g-10-a.akamaihd.net	a116.dscw81.akamai.net
igcdn-videos-g-11-a.akamaihd.net	a124.dscw81.akamai.net
igcdn-videos-g-12-a.akamaihd.net	a132.dscw81.akamai.net
igcdn-videos-g-13-a.akamaihd.net	a140.dscw81.akamai.net
igcdn-videos-g-14-a.akamaihd.net	a148.dscw81.akamai.net
igcdn-videos-g-15-a.akamaihd.net	a156.dscw81.akamai.net
igcdn-videos-g-16-a.akamaihd.net	a164.dscw81.akamai.net
igcdn-videos-g-17-a.akamaihd.net	a172.dscw81.akamai.net
igcdn-videos-g-18-a.akamaihd.net	a180.dscw81.akamai.net
igcdn-videos-g-19-a.akamaihd.net	a188.dscw81.akamai.net
igcdn-videos-h-0-a.akamaihd.net	a37.dscw81.akamai.net
igcdn-videos-h-1-a.akamaihd.net	a45.dscw81.akamai.net
igcdn-videos-h-2-a.akamaihd.net	a53.dscw81.akamai.net
igcdn-videos-h-3-a.akamaihd.net	a61.dscw81.akamai.net
igcdn-videos-h-4-a.akamaihd.net	a69.dscw81.akamai.net
igcdn-videos-h-5-a.akamaihd.net	a77.dscw81.akamai.net
igcdn-videos-h-6-a.akamaihd.net	a85.dscw81.akamai.net
igcdn-videos-h-7-a.akamaihd.net	a93.dscw81.akamai.net
igcdn-videos-h-8-a.akamaihd.net	a101.dscw81.akamai.net
igcdn-videos-h-9-a.akamaihd.net	a109.dscw81.akamai.net
igcdn-videos-h-10-a.akamaihd.net	a117.dscw81.akamai.net
igcdn-videos-h-11-a.akamaihd.net	a125.dscw81.akamai.net
igcdn-videos-h-12-a.akamaihd.net	a133.dscw81.akamai.net
igcdn-videos-h-13-a.akamaihd.net	a141.dscw81.akamai.net
igcdn-videos-h-14-a.akamaihd.net	a149.dscw81.akamai.net
igcdn-videos-h-15-a.akamaihd.net	a157.dscw81.akamai.net
igcdn-videos-h-16-a.akamaihd.net	a165.dscw81.akamai.net
igcdn-videos-h-17-a.akamaihd.net	a173.dscw81.akamai.net
igcdn-videos-h-18-a.akamaihd.net	a181.dscw81.akamai.net
igcdn-videos-h-19-a.akamaihd.net	a189.dscw81.akamai.net
igexternal-a.akamaihd.net	a1836.dsw4.akamai.net
iglive-a.akamaihd.net	a2047.dscw80.akamai.net
ig-l-a-a.akamaihd.net	a2047.dscg.akamai.net
ig-l-b-a.akamaihd.net	a2047.dscg.akamai.net
ig-l-c-a.akamaihd.net	a2047.dscg.akamai.net
ig-l-d-a.akamaihd.net	a2047.dscg.akamai.net
ig-s-a-a.akamaihd.net	a2047.dscg.akamai.net
ig-s-b-a.akamaihd.net	a2047.dscg.akamai.net
ig-s-c-a.akamaihd.net	a2047.dscg.akamai.net
ig-s-d-a.akamaihd.net	a2047.dscg.akamai.net
instagramimages-a.akamaihd.net	a1406.dscw76.akamai.net
instagramstatic-a.akamaihd.net	a1168.dsw4.akamai.net

# LINE
line.me	-
www.line.me	-
access.line.me	e1102.a.akamaiedge.net
access-auto.line.me	e1102.a.akamaiedge.net
accountpage.line.me	-
ace.line.me	ace-kr.line.me.akadns.net
admin-official.line.me	-
agecheck.line.me	-
aillis.line.me	-
air.line.me	-
api.line.me	e1102.a.akamaiedge.net
api2.line.me	-
api-rangers.line.me	-
app-manga.line.me	-
at.line.me	-
at-blog.line.me	-
at-talk.line.me	-
audition.line.me	-
b612.line.me	-
baito.line.me	-
blog.line.me	-
blog-at.line.me	blog-01.livedoor.jp
blog-cms.line.me	-
botawards.line.me	-
business.line.me	-
business-store.line.me	-
buy.line.me	-
callback.line.me	-
camera.line.me	-
camera-official-blog.line.me	blog-01.livedoor.jp
cc.line.me	-
clova-blog.line.me	-
contact.line.me	-
contact-cc.line.me	-
creator.line.me	-
creator-mag.line.me	blog-01.livedoor.jp
creator-static.line.me	e1102.g.akamaiedge.net
cube.line.me	e1102.a.akamaiedge.net
d.line.me	-
decostudio.line.me	-
delima.line.me	-
devdocs.line.me	-
developers.line.me	-
ec.line.me	-
events.line.me	-
event-web.line.me	e1102.d.akamaiedge.net
ezstore.line.me	-
feedback.line.me	-
foodie.line.me	-
fortune.line.me	-
fortune-cms.line.me	-
fs.line.me	-
game.line.me	-
3rdanniversary.game.line.me	-
bingo.game.line.me	-
bleach.game.line.me	-
bnms.game.line.me	-
brownfarm.game.line.me	-
chocolat.game.line.me	-
eiyu-ranbu.game.line.me	-
gdc.game.line.me	-
growthy.game.line.me	-
growthy-eis.game.line.me	-
growthy-glog.game.line.me	-
itemget.game.line.me	-
mail.game.line.me	-
mkt-tool.game.line.me	-
monitoring.game.line.me	-
noble.game.line.me	-
poko.game.line.me	-
qars.game.line.me	-
rangers.game.line.me	-
reconquista.game.line.me	-
rssreader.game.line.me	-
sign.game.line.me	-
tsumtsum.game.line.me	-
game-blog.line.me	blog-01.livedoor.jp
gift-blog.line.me	blog-01.livedoor.jp
help.line.me	e1102.b.akamaiedge.net
help2.line.me	e1102.a1.akamaiedge.net
jobs.line.me	-
keep.line.me	e1102.d.akamaiedge.net
lan.line.me	lan-o.line.me
lan3rd.line.me	e1102.a.akamaiedge.net
lbc.line.me	-
lcp-checkout.line.me	-
lcs.line.me	lcs-kr.line.me.akadns.net
lg-cs.line.me	-
lgurl.line.me	-
linecreative.line.me	-
lineit.line.me	e1102.g.akamaiedge.net
line-research.line.me	-
list.line.me	-
live.line.me	-
looks.line.me	-
mall.line.me	-
man.line.me	-
manga.line.me	-
manual-at.line.me	-
media.line.me	e1102.d.akamaiedge.net
mobile.line.me	-
mobile-blog.line.me	blog-01.livedoor.jp
music.line.me	-
music-jp-cms.line.me	-
music-jp-coupon.line.me	-
music-mag.line.me	blog-01.livedoor.jp
nc.line.me	nc-kr.line.me.akadns.net
news.line.me	-
noble-blog.line.me	-
notice.line.me	notice-o.line.me
notice2.line.me	notice2-o.line.me
notify-api.line.me	-
notify-bot.line.me	-
official-blog.line.me	-
page.line.me	-
partner.line.me	-
partner-points.line.me	-
pay.line.me	-
pazfre-blog.line.me	blog-01.livedoor.jp
play.line.me	-
lp.play.line.me	-
points.line.me	-
pr.line.me	-
protostar.line.me	nucleo-apps-jp2.line-apps.com
pr-shindan.line.me	-
qr-official.line.me	-
rangers.line.me	-
refund.line.me	-
research-platform.line.me	blog-01.livedoor.jp
sandbox-web-pay.line.me	-
scc.line.me	-
scdn.line.me	e1102.g.akamaiedge.net
schedule.line.me	-
seller.line.me	-
shopping.line.me	e1102.a.akamaiedge.net
social-plugins.line.me	e1102.d.akamaiedge.net
stage.line.me	-
sticker-contest.line.me	-
store.line.me	-
store-bill.line.me	-
survey-blog.line.me	blog-01.livedoor.jp
taxi.line.me	-
terms.line.me	e1102.b.akamaiedge.net
terms2.line.me	e1102.a1.akamaiedge.net
timeline.line.me	e1102.g.akamaiedge.net
today.line.me	e1102.a.akamaiedge.net
api.today.line.me	e1102.a.akamaiedge.net
tr.line.me	-
optout.tr.line.me	-
tv.line.me	tv-kr.line-apps.com.akadns.net
tv-ac.line.me	-
tv-kr.line.me	-
tv-sg.line.me	-
tv-stage.line.me	-
u.line.me	-
w.line.me	e1102.a1.akamaiedge.net
web-pay.line.me	-
webpos.line.me	-
w-jp.line.me	-
wow.line.me	-
wow-blog.line.me	blog-01.livedoor.jp
line.today	-
accountpage.line-apps.com	-
api-camera.line-apps.com	-
org.app.line-apps.com	-
asia-vod-linetv.line-apps.com	e1102.d.akamaiedge.net
b612-api.line-apps.com	-
blog.line-apps.com	-
bubbles2.line-apps.com	-
camera-log.line-apps.com	-
cast-chat-001.line-apps.com	-
cast-chat-002.line-apps.com	-
cast-chat-003.line-apps.com	-
cast-chat-004.line-apps.com	-
cast-chat-005.line-apps.com	-
cast-chat-006.line-apps.com	-
cast-chat-007.line-apps.com	-
cast-chat-008.line-apps.com	-
cast-chat-009.line-apps.com	-
cast-chat-010.line-apps.com	-
cast-chat-011.line-apps.com	-
cast-chat-012.line-apps.com	-
cast-chat-013.line-apps.com	-
cast-chat-014.line-apps.com	-
cast-chat-015.line-apps.com	-
cast-chat-016.line-apps.com	-
cast-chat-017.line-apps.com	-
cast-chat-018.line-apps.com	-
cast-chat-019.line-apps.com	-
cast-chat-020.line-apps.com	-
cast-chat-021.line-apps.com	-
cast-chat-022.line-apps.com	-
cast-chat-023.line-apps.com	-
cast-chat-024.line-apps.com	-
cast-chat-025.line-apps.com	-
cast-chat-026.line-apps.com	-
cast-chat-027.line-apps.com	-
cast-chat-028.line-apps.com	-
cast-chat-029.line-apps.com	-
cast-chat-030.line-apps.com	-
cast-chat-031.line-apps.com	-
cast-chat-032.line-apps.com	-
cast-chat-033.line-apps.com	-
cast-chat-034.line-apps.com	-
cast-chat-035.line-apps.com	-
cast-chat-036.line-apps.com	-
cast-chat-037.line-apps.com	-
cast-chat-038.line-apps.com	-
cast-chat-039.line-apps.com	-
cast-chat-040.line-apps.com	-
cast-chat-041.line-apps.com	-
cast-chat-042.line-apps.com	-
cast-chat-043.line-apps.com	-
cast-chat-044.line-apps.com	-
cast-chat-045.line-apps.com	-
cast-chat-046.line-apps.com	-
cast-chat-047.line-apps.com	-
cast-chat-048.line-apps.com	-
cast-chat-049.line-apps.com	-
cast-chat-050.line-apps.com	-
cast-chat-051.line-apps.com	-
cast-chat-052.line-apps.com	-
cast-chat-053.line-apps.com	-
cast-chat-054.line-apps.com	-
cast-chat-055.line-apps.com	-
cast-chat-056.line-apps.com	-
cast-chat-057.line-apps.com	-
cast-chat-058.line-apps.com	-
cast-chat-059.line-apps.com	-
cast-chat-060.line-apps.com	-
cast-chat-061.line-apps.com	-
cast-chat-062.line-apps.com	-
cast-chat-063.line-apps.com	-
cast-chat-064.line-apps.com	-
cast-chat-065.line-apps.com	-
cast-chat-066.line-apps.com	-
cast-chat-067.line-apps.com	-
cast-chat-068.line-apps.com	-
cast-chat-069.line-apps.com	-
cast-chat-070.line-apps.com	-
cast-chat-071.line-apps.com	-
cast-chat-072.line-apps.com	-
cast-chat-073.line-apps.com	-
cast-chat-074.line-apps.com	-
cast-chat-075.line-apps.com	-
cast-chat-076.line-apps.com	-
cast-chat-077.line-apps.com	-
cast-chat-078.line-apps.com	-
cast-chat-079.line-apps.com	-
cast-chat-080.line-apps.com	-
cast-chat-081.line-apps.com	-
cast-chat-082.line-apps.com	-
cast-chat-083.line-apps.com	-
cast-chat-084.line-apps.com	-
cast-chat-085.line-apps.com	-
cast-chat-086.line-apps.com	-
cast-chat-087.line-apps.com	-
cast-chat-088.line-apps.com	-
cast-chat-089.line-apps.com	-
cast-chat-090.line-apps.com	-
cast-chat-091.line-apps.com	-
cast-chat-092.line-apps.com	-
cast-chat-093.line-apps.com	-
cast-chat-094.line-apps.com	-
cast-chat-095.line-apps.com	-
cast-chat-096.line-apps.com	-
cast-chat-097.line-apps.com	-
cast-chat-098.line-apps.com	-
cast-chat-099.line-apps.com	-
cast-chat-100.line-apps.com	-
cast-chat-101.line-apps.com	-
cast-chat-102.line-apps.com	-
cast-chat-103.line-apps.com	-
cdn.line-apps.com	a1682.g.akamai.net
cdn2-obs.line-apps.com	obs-sg-addr.line-apps.com
cdn-lg.line-apps.com	a1205.g.akamai.net
cdn-matome.line-apps.com	d3d8lrzagfq76q.cloudfront.net
cdn-obs.line-apps.com	a1123.w10.akamai.net
cdn-obs-beta.line-apps.com	-
cdn-stf.line-apps.com	a1702.w10.akamai.net
cdn-stickershop.line-apps.com	a1903.g.akamai.net
child-keygen-sdbx.line-apps.com	-
ch-news.line-apps.com	e1102.g.akamaiedge.net
ch-news-beta.line-apps.com	e30199.g.akamaiedge.net
cnts-pay.line-apps.com	-
coupon.line-apps.com	e3998.d.akamaiedge.net
dev-asia-vod-linetv.line-apps.com	e1102.d.akamaiedge.net
dev-gb-vod-linetv.line-apps.com	e1102.d.akamaiedge.net
ecdn.line-apps.com	a1496.w39.akamai.net
foodie-api.line-apps.com	-
freecoins.line-apps.com	-
gb-vod-linetv.line-apps.com	e1102.d.akamaiedge.net
img-pay.line-apps.com	-
lanimg.line-apps.com	-
lanimg-beta.line-apps.com	-
lg-borne.line-apps.com	-
lg-borne-ppp.line-apps.com	a1982.w10.akamai.net
lg-growthy.line-apps.com	-
lg-growthy-sdbx.line-apps.com	-
lg-push-web.line-apps.com	-
line-bot-cms-app-web.line-apps.com	-
litmus.line-apps.com	a1983.g.akamai.net
live-api.line-apps.com	live-api-jp.line-apps.com
live-burst-api.line-apps.com	live-burst-api-jp.line-apps.com
log1-amp.line-apps.com	-
lssapi.line-apps.com	-
man-api.line-apps.com	-
music-api.line-apps.com	-
music-jp-dn.line-apps.com	e1102.d.akamaiedge.net
news.line-apps.com	-
obs.line-apps.com	obs-jp-addr.line-apps.com
obs-beta.line-apps.com	-
obs-cn.line-apps.com	obs-kr-addr.line-apps.com
obs-cn-api.line-apps.com	obs-kr-addr.line-apps.com
obs-de.line-apps.com	obs-de-addr.line-apps.com
obs-de-addr.line-apps.com	-
obs-ir.line-apps.com	obs-de-addr.line-apps.com
obs-jp.line-apps.com	obs-jp-addr.line-apps.com
obs-jp-addr.line-apps.com	-
obs-kr.line-apps.com	obs-kr-addr.line-apps.com
obs-kr-addr.line-apps.com	-
obs-rc.line-apps.com	-
obs-sg.line-apps.com	obs-sg-addr.line-apps.com
obs-sg-addr.line-apps.com	-
obs-th.line-apps.com	obs-sg-addr.line-apps.com
obs-tw.line-apps.com	obs-jp-addr.line-apps.com
obs-us.line-apps.com	obs-us-addr.line-apps.com
obs-us-addr.line-apps.com	-
origin-stf.line-apps.com	-
payg-log.line-apps.com	kr-payg-log.line-apps.com.lheos.com.akadns.net
p-official.line-apps.com	p-official.line-apps.com.cdngc.net
promotion-freecoins.line-apps.com	-
scdn.line-apps.com	e1102.g.akamaiedge.net
sdbx-help3rd.line-apps.com	-
sdbx-lan3rd.line-apps.com	-
sdbx-terms3rd.line-apps.com	-
sstatic-cbox.line-apps.com	e1102.g.akamaiedge.net
sstatic-linetv.line-apps.com	e1102.g.akamaiedge.net
static-rangers.line-apps.com	-
torimochi.line-apps.com	-
ts.line-apps.com	-
tv1-pt.line-apps.com	a95.w39.akamai.net
tv2-pt.line-apps.com	a1021.w39.akamai.net
tv-img.line-apps.com	a494.w39.akamai.net
tv-rmcnmv.line-apps.com	a1244.w39.akamai.net
tv-rmcnmv-pt.line-apps.com	a393.w39.akamai.net
vdn-obs.line-apps.com	e1102.d.akamaiedge.net
weather.line-apps.com	-
xcdn-cn.line-apps.com	-
xcdn-cn-prf.line-apps.com	xcdn-cn.line-apps.com
xcdn-cn-shp.line-apps.com	xcdn-cn.line-apps.com
xcdn-cn-stk.line-apps.com	xcdn-cn.line-apps.com
xcdn-de.line-apps.com	-
xcdn-de-prf.line-apps.com	xcdn-de.line-apps.com
xcdn-de-shp.line-apps.com	xcdn-de.line-apps.com
xcdn-de-stk.line-apps.com	xcdn-de.line-apps.com
xcdn-jp.line-apps.com	-
xcdn-jp-prf.line-apps.com	xcdn-jp.line-apps.com
xcdn-jp-shp.line-apps.com	xcdn-jp.line-apps.com
xcdn-jp-stk.line-apps.com	xcdn-jp.line-apps.com
xcdn-kr.line-apps.com	-
xcdn-kr-prf.line-apps.com	xcdn-kr.line-apps.com
xcdn-kr-shp.line-apps.com	xcdn-kr.line-apps.com
xcdn-kr-stk.line-apps.com	xcdn-kr.line-apps.com
xcdn-sg.line-apps.com	-
xcdn-sg-prf.line-apps.com	xcdn-sg.line-apps.com
xcdn-sg-shp.line-apps.com	xcdn-sg.line-apps.com
xcdn-sg-stk.line-apps.com	xcdn-sg.line-apps.com
xcdn-us.line-apps.com	-
xcdn-us-prf.line-apps.com	xcdn-us.line-apps.com
xcdn-us-shp.line-apps.com	xcdn-us.line-apps.com
xcdn-us-stk.line-apps.com	xcdn-us.line-apps.com
yuki.line-apps.com	-
line-beta.me	-
event-web.line-beta.me	e30199.d.akamaiedge.net
today.line-beta.me	e30199.a.akamaiedge.net
api.today.line-beta.me	e30199.a.akamaiedge.net
linefriends.com	-
www.linefriends.com	-
cdn-game.linefriends.com	e1102.d.akamaiedge.net
store-cdn.linefriends.com	-
linelive.me	-
lss.linelive.me	e1102.d.akamaiedge.net
d.line-scdn.net	e3998.d.akamaiedge.net
game.line-scdn.net	e3998.d.akamaiedge.net
game-beta.line-scdn.net	e3998.d.akamaiedge.net
lg-borne-ppp.line-scdn.net	e3998.d.akamaiedge.net
lss.line-scdn.net	e3998.d.akamaiedge.net
obs.line-scdn.net	e3998.d.akamaiedge.net
profile.line-scdn.net	e3998.d.akamaiedge.net
shop.line-scdn.net	e3998.d.akamaiedge.net
stickershop.line-scdn.net	e3998.d.akamaiedge.net
stickershop-beta.line-scdn.net	e3998.d.akamaiedge.net
today.line-scdn.net	e3998.d.akamaiedge.net
vdn-obs.line-scdn.net	e1102.d.akamaiedge.net
vdn-obs-ir.line-scdn.net	obs-de-addr.line-apps.com
vdn-obs-kr.line-scdn.net	-
vdn-obs-rc.line-scdn.net	-
vdn-obs-th.line-scdn.net	obs-sg-addr.line-apps.com
w.line-scdn.net	e3998.d.akamaiedge.net
linetoday.com	-
dl.stickershop.line.beta.naver.jp	e30199.d.akamaiedge.net
line.naver.jp	-
dl.app.line.naver.jp	a1961.w10.akamai.net
dl.appresource.line.naver.jp	a1726.g2.akamai.net
biz.line.naver.jp	-
callback.line.naver.jp	-
camera.line.naver.jp	-
api.camera.line.naver.jp	-
beta.api.camera.line.naver.jp	-
beta.camera.line.naver.jp	-
dl.camimg.line.naver.jp	a1170.w10.akamai.net
beta.dl.camimg.line.naver.jp	-
channel.line.naver.jp	-
channel-apis.line.naver.jp	-
channel-apis-rc.line.naver.jp	-
channel-rc.line.naver.jp	-
dl.common.line.naver.jp	a610.g.akamai.net
coupon.line.naver.jp	-
admin.coupon.line.naver.jp	-
coupon-img.line.naver.jp	-
dl.desktop.line.naver.jp	a1896.g.akamai.net
developers.line.naver.jp	-
dl.line.naver.jp	a38.g.akamai.net
dl-channel.line.naver.jp	a1168.w10.akamai.net
feedback.line.naver.jp	-
admin.feedback.line.naver.jp	-
fortune.line.naver.jp	-
api.freecoin.line.naver.jp	-
ch.freecoin.line.naver.jp	-
ga.line.naver.jp	legy-jp-addr.line.naver.jp
ga2.line.naver.jp	legy-jp-addr.line.naver.jp
ga2g.line.naver.jp	legy-de-addr.line.naver.jp
ga2i.line.naver.jp	legy-de-addr.line.naver.jp
ga2k.line.naver.jp	legy-kr-long.line-apps.com.akadns.net
ga2s.line.naver.jp	legy-sg-addr.line.naver.jp
ga2u.line.naver.jp	legy-us-addr.line.naver.jp
ga2v.line.naver.jp	legy-vn.line-apps.com.akadns.net
ga2w.line.naver.jp	legy-kr-long.line-apps.com.akadns.net
ga2x.line.naver.jp	legy.g.line-apps.com
ga2z.line.naver.jp	legy-jp.line-apps.com.akadns.net
game.line.naver.jp	-
gameapp.line.naver.jp	-
gb.line.naver.jp	legy-jp-addr.line.naver.jp
gbg.line.naver.jp	legy-de-addr.line.naver.jp
gbi.line.naver.jp	legy-de-addr.line.naver.jp
gbk.line.naver.jp	legy-kr-long.line-apps.com.akadns.net
gbs.line.naver.jp	legy-sg-addr.line.naver.jp
gbu.line.naver.jp	legy-us-addr.line.naver.jp
gbv.line.naver.jp	legy-vn.line-apps.com.akadns.net
gbw.line.naver.jp	legy-kr-long.line-apps.com.akadns.net
gbx.line.naver.jp	legy.g.line-apps.com
gbz.line.naver.jp	legy-jp.line-apps.com.akadns.net
gd2.line.naver.jp	legy-jp-addr.line.naver.jp
gd2g.line.naver.jp	legy-de-addr.line.naver.jp
gd2i.line.naver.jp	legy-de-addr.line.naver.jp
gd2k.line.naver.jp	legy-kr-short.line-apps.com.akadns.net
gd2s.line.naver.jp	legy-sg-addr.line.naver.jp
gd2u.line.naver.jp	legy-us-addr.line.naver.jp
gd2v.line.naver.jp	legy-vn.line-apps.com.akadns.net
gd2w.line.naver.jp	legy-kr-short.line-apps.com.akadns.net
gd2x.line.naver.jp	legy.g.line-apps.com
gd2z.line.naver.jp	legy-jp.line-apps.com.akadns.net
gf.line.naver.jp	legy-jp-addr.line.naver.jp
gfg.line.naver.jp	legy-de-addr.line.naver.jp
gfi.line.naver.jp	legy-de-addr.line.naver.jp
gfk.line.naver.jp	legy-kr-short.line-apps.com.akadns.net
gfp.line.naver.jp	legy-jp-addr.line.naver.jp
gfpg.line.naver.jp	legy-de-addr.line.naver.jp
gfpi.line.naver.jp	legy-de-addr.line.naver.jp
gfpk.line.naver.jp	legy-kr-long.line-apps.com.akadns.net
gfps.line.naver.jp	legy-sg-addr.line.naver.jp
gfpu.line.naver.jp	legy-us-addr.line.naver.jp
gfpv.line.naver.jp	legy-vn.line-apps.com.akadns.net
gfpw.line.naver.jp	legy-kr-long.line-apps.com.akadns.net
gfpx.line.naver.jp	legy.g.line-apps.com
gfpz.line.naver.jp	legy-jp.line-apps.com.akadns.net
gfs.line.naver.jp	legy-sg-addr.line.naver.jp
gfu.line.naver.jp	legy-us-addr.line.naver.jp
gfv.line.naver.jp	legy-vn.line-apps.com.akadns.net
gfw.line.naver.jp	legy-kr-short.line-apps.com.akadns.net
gfx.line.naver.jp	legy.g.line-apps.com
gfz.line.naver.jp	legy-jp.line-apps.com.akadns.net
gi.line.naver.jp	legy-jp-addr.line.naver.jp
gig.line.naver.jp	legy-de-addr.line.naver.jp
gii.line.naver.jp	legy-de-addr.line.naver.jp
gik.line.naver.jp	legy-kr-short.line-apps.com.akadns.net
gis.line.naver.jp	legy-sg-addr.line.naver.jp
giu.line.naver.jp	legy-us-addr.line.naver.jp
giv.line.naver.jp	legy-vn.line-apps.com.akadns.net
giw.line.naver.jp	legy-kr-short.line-apps.com.akadns.net
gix.line.naver.jp	legy.g.line-apps.com
giz.line.naver.jp	legy-jp.line-apps.com.akadns.net
gm.line.naver.jp	legy-jp-addr.line.naver.jp
gm2.line.naver.jp	legy-jp-addr.line.naver.jp
gm2k.line.naver.jp	legy-kr-short.line-apps.com.akadns.net
gm2u.line.naver.jp	legy-us-addr.line.naver.jp
gm2v.line.naver.jp	legy-vn.line-apps.com.akadns.net
gm2w.line.naver.jp	legy-kr-short.line-apps.com.akadns.net
gm2x.line.naver.jp	legy.g.line-apps.com
gm2z.line.naver.jp	legy-jp.line-apps.com.akadns.net
gmg.line.naver.jp	legy-de-addr.line.naver.jp
gmi.line.naver.jp	legy-de-addr.line.naver.jp
gmk.line.naver.jp	legy-kr-long.line-apps.com.akadns.net
gmp.line.naver.jp	legy-jp-addr.line.naver.jp
gmpg.line.naver.jp	legy-de-addr.line.naver.jp
gmpi.line.naver.jp	legy-de-addr.line.naver.jp
gmpk.line.naver.jp	legy-kr-short.line-apps.com.akadns.net
gmps.line.naver.jp	legy-sg-addr.line.naver.jp
gmpu.line.naver.jp	legy-us-addr.line.naver.jp
gmpv.line.naver.jp	legy-vn.line-apps.com.akadns.net
gmpw.line.naver.jp	legy-kr-short.line-apps.com.akadns.net
gmpx.line.naver.jp	legy.g.line-apps.com
gmpz.line.naver.jp	legy-jp.line-apps.com.akadns.net
gms.line.naver.jp	legy-sg-addr.line.naver.jp
gmu.line.naver.jp	legy-us-addr.line.naver.jp
gmv.line.naver.jp	legy-vn.line-apps.com.akadns.net
gmw.line.naver.jp	legy-kr-long.line-apps.com.akadns.net
gmx.line.naver.jp	legy.g.line-apps.com
gmz.line.naver.jp	legy-jp.line-apps.com.akadns.net
gp.line.naver.jp	legy-jp-addr.line.naver.jp
gs.line.naver.jp	legy-jp-addr.line.naver.jp
gsg.line.naver.jp	legy-de-addr.line.naver.jp
gsi.line.naver.jp	legy-de-addr.line.naver.jp
gsk.line.naver.jp	legy-kr-long.line-apps.com.akadns.net
gss.line.naver.jp	legy-sg-addr.line.naver.jp
gsu.line.naver.jp	legy-us-addr.line.naver.jp
gsv.line.naver.jp	legy-vn.line-apps.com.akadns.net
gsw.line.naver.jp	legy-kr-long.line-apps.com.akadns.net
gsx.line.naver.jp	legy.g.line-apps.com
gsz.line.naver.jp	legy-jp.line-apps.com.akadns.net
gw.line.naver.jp	legy-jp-addr.line.naver.jp
gwg.line.naver.jp	legy-de-addr.line.naver.jp
gwi.line.naver.jp	legy-de-addr.line.naver.jp
gwk.line.naver.jp	legy-kr-short.line-apps.com.akadns.net
gws.line.naver.jp	legy-sg-addr.line.naver.jp
gwu.line.naver.jp	legy-us-addr.line.naver.jp
gwv.line.naver.jp	legy-vn.line-apps.com.akadns.net
gww.line.naver.jp	legy-kr-short.line-apps.com.akadns.net
gwx.line.naver.jp	legy.g.line-apps.com
gwz.line.naver.jp	legy-jp.line-apps.com.akadns.net
gxx.line.naver.jp	legy.g.line-apps.com
homeapi.line.naver.jp	-
rr.img.line.naver.jp	dnnx3exhrd7to.cloudfront.net
legy-de-addr.line.naver.jp	-
legy-de-long.line.naver.jp	legy-de-addr.line.naver.jp
legy-de-short.line.naver.jp	legy-de-addr.line.naver.jp
legy-jp.line.naver.jp	legy-jp-addr.line.naver.jp
legy-jp-addr.line.naver.jp	-
legy-jp-addr-long.line.naver.jp	-
legy-jp-addr-short.line.naver.jp	-
legy-jp-long.line.naver.jp	legy-jp-addr-long.line.naver.jp
legy-jp-short.line.naver.jp	legy-jp-addr-short.line.naver.jp
legy-kr-addr.line.naver.jp	-
legy-kr-long.line.naver.jp	legy-kr-long.line-apps.com.akadns.net
legy-kr-short.line.naver.jp	legy-kr-short.line-apps.com.akadns.net
legy-sg-addr.line.naver.jp	-
legy-sg-long.line.naver.jp	legy-sg-addr.line.naver.jp
legy-sg-short.line.naver.jp	legy-sg-addr.line.naver.jp
legy-us-addr.line.naver.jp	-
legy-us-long.line.naver.jp	legy-us-addr.line.naver.jp
legy-us-short.line.naver.jp	legy-us-addr.line.naver.jp
lineat-navi.line.naver.jp	-
media.line.naver.jp	-
news.line.naver.jp	-
official.line.naver.jp	-
account.official.line.naver.jp	-
dl.official.line.naver.jp	a1170.w10.akamai.net
dl-obs.official.line.naver.jp	a1867.w10.akamai.net
vid.official.line.naver.jp	-
os.line.naver.jp	-
dl.os.line.naver.jp	a1168.w10.akamai.net
osc.line.naver.jp	-
dl.osc.line.naver.jp	a1441.w10.akamai.net
os-pub.line.naver.jp	-
os-vn.line.naver.jp	-
play.line.naver.jp	-
pr.line.naver.jp	-
dl.profile.line.naver.jp	a1284.w10.akamai.net
dl-hsp.profile.line.naver.jp	a1479.w10.akamai.net
qr.line.naver.jp	-
rcvmail.line.naver.jp	-
obs-cn.rts.line.naver.jp	obs-kr-addr.line-apps.com
obs-th.rts.line.naver.jp	-
obs-tw.rts.line.naver.jp	obs-jp-addr.line-apps.com
sdl-shop.line.naver.jp	e5282.b.akamaiedge.net
sdl-stickershop.line.naver.jp	e5282.b.akamaiedge.net
dl.shop.line.naver.jp	a1123.w10.akamai.net
static.line.naver.jp	-
stf.line.naver.jp	-
dl.stickershop.line.naver.jp	a908.w10.akamai.net
org.stickershop.line.naver.jp	-
supporters.line.naver.jp	-
admin.supporters.line.naver.jp	-
tauth.line.naver.jp	-
timeline.line.naver.jp	-
vaccine.line.naver.jp	-
dl.vaccine.line.naver.jp	a1877.w10.akamai.net
dl.static.minigame.play.naver.jp	e1102.g.akamaiedge.net

# Pinterest
pinterest.com	prod.pinterest.global.map.fastly.net
www.pinterest.com	prod.pinterest.global.map.fastly.net
about.pinterest.com	prod.pinterest.global.map.fastly.net
accounts.pinterest.com	prod.pinterest.global.map.fastly.net
accounts-oauth.pinterest.com	prod.pinterest.global.map.fastly.net
ads.pinterest.com	prod.pinterest.global.map.fastly.net
amp.pinterest.com	prod.pinterest.global.map.fastly.net
analytics.pinterest.com	prod.pinterest.global.map.fastly.net
anket.pinterest.com	anket-prod-1926193708.us-east-1.elb.amazonaws.com
api.pinterest.com	prod.pinterest.global.map.fastly.net
assets.pinterest.com	prod.pinterest.global.map.fastly.net
blog.pinterest.com	prod.pinterest.global.map.fastly.net
business.pinterest.com	prod.pinterest.global.map.fastly.net
canary.pinterest.com	prod.pinterest.global.map.fastly.net
careers.pinterest.com	prod.pinterest.global.map.fastly.net
commerce.pinterest.com	prod.pinterest.global.map.fastly.net
dev.pinterest.com	vpc-devsite-1231932404.us-east-1.elb.amazonaws.com
developers.pinterest.com	vpc-devsite-1231932404.us-east-1.elb.amazonaws.com
email.pinterest.com	prod.pinterest.global.map.fastly.net
engineering.pinterest.com	prod.pinterest.global.map.fastly.net
help.pinterest.com	prod.pinterest.global.map.fastly.net
labs.pinterest.com	prod.pinterest.global.map.fastly.net
latest.pinterest.com	prod.pinterest.global.map.fastly.net
log.pinterest.com	prod.pinterest.global.map.fastly.net
mdp.pinterest.com	prod.pinterest.global.map.fastly.net
media-cache-ec0.pinterest.com	prod.pinterest.global.map.fastly.net
media-cache-ec1.pinterest.com	prod.pinterest.global.map.fastly.net
partners-api.pinterest.com	vpc-widgets-8791aee8ec8279a4.elb.us-east-1.amazonaws.com
passets.pinterest.com	prod.pinterest.global.map.fastly.net
passets-cdn.pinterest.com	prod.pinterest.global.map.fastly.net
passets-ec.pinterest.com	prod.pinterest.global.map.fastly.net
policy.pinterest.com	dualstack.h2.pinterest.map.fastly.net
post.pinterest.com	-
support.pinterest.com	prod.pinterest.global.map.fastly.net
trk.pinterest.com	vpc-widgets-1106562013.us-east-1.elb.amazonaws.com
widgets.pinterest.com	prod.pinterest.global.map.fastly.net
ar.pinterest.com	prod.pinterest.global.map.fastly.net
au.pinterest.com	prod.pinterest.global.map.fastly.net
br.pinterest.com	prod.pinterest.global.map.fastly.net
cl.pinterest.com	prod.pinterest.global.map.fastly.net
co.pinterest.com	prod.pinterest.global.map.fastly.net
ct.pinterest.com	prod.pinterest.global.map.fastly.net
cz.pinterest.com	prod.pinterest.global.map.fastly.net
de.pinterest.com	prod.pinterest.global.map.fastly.net
dk.pinterest.com	prod.pinterest.global.map.fastly.net
es.pinterest.com	prod.pinterest.global.map.fastly.net
fi.pinterest.com	prod.pinterest.global.map.fastly.net
fr.pinterest.com	prod.pinterest.global.map.fastly.net
gb.pinterest.com	prod.pinterest.global.map.fastly.net
gr.pinterest.com	prod.pinterest.global.map.fastly.net
hu.pinterest.com	prod.pinterest.global.map.fastly.net
id.pinterest.com	prod.pinterest.global.map.fastly.net
in.pinterest.com	prod.pinterest.global.map.fastly.net
it.pinterest.com	prod.pinterest.global.map.fastly.net
jp.pinterest.com	prod.pinterest.global.map.fastly.net
kr.pinterest.com	prod.pinterest.global.map.fastly.net
nl.pinterest.com	prod.pinterest.global.map.fastly.net
no.pinterest.com	prod.pinterest.global.map.fastly.net
nz.pinterest.com	prod.pinterest.global.map.fastly.net
pl.pinterest.com	prod.pinterest.global.map.fastly.net
pt.pinterest.com	prod.pinterest.global.map.fastly.net
ro.pinterest.com	prod.pinterest.global.map.fastly.net
ru.pinterest.com	prod.pinterest.global.map.fastly.net
se.pinterest.com	prod.pinterest.global.map.fastly.net
sk.pinterest.com	prod.pinterest.global.map.fastly.net
tr.pinterest.com	prod.pinterest.global.map.fastly.net
uk.pinterest.com	prod.pinterest.global.map.fastly.net
za.pinterest.com	prod.pinterest.global.map.fastly.net
pinterest.at	prod.pinterest.global.map.fastly.net
www.pinterest.at	prod.pinterest.global.map.fastly.net
pinterest.co.at	prod.pinterest.global.map.fastly.net
www.pinterest.co.at	prod.pinterest.global.map.fastly.net
pinterest.com.au	prod.pinterest.global.map.fastly.net
www.pinterest.com.au	prod.pinterest.global.map.fastly.net
pinterest.ca	prod.pinterest.global.map.fastly.net
www.pinterest.ca	prod.pinterest.global.map.fastly.net
pinterest.ch	prod.pinterest.global.map.fastly.net
www.pinterest.ch	prod.pinterest.global.map.fastly.net
pinterest.cl	prod.pinterest.global.map.fastly.net
www.pinterest.cl	prod.pinterest.global.map.fastly.net
pinterest.de	prod.pinterest.global.map.fastly.net
www.pinterest.de	prod.pinterest.global.map.fastly.net
pinterest.dk	prod.pinterest.global.map.fastly.net
www.pinterest.dk	prod.pinterest.global.map.fastly.net
pinterest.es	prod.pinterest.global.map.fastly.net
www.pinterest.es	prod.pinterest.global.map.fastly.net
pinterest.fr	prod.pinterest.global.map.fastly.net
www.pinterest.fr	prod.pinterest.global.map.fastly.net
pinterest.ie	prod.pinterest.global.map.fastly.net
www.pinterest.ie	prod.pinterest.global.map.fastly.net
pinterest.jp	prod.pinterest.global.map.fastly.net
www.pinterest.jp	prod.pinterest.global.map.fastly.net
pinterest.kr	prod.pinterest.global.map.fastly.net
www.pinterest.kr	prod.pinterest.global.map.fastly.net
pinterest.co.kr	prod.pinterest.global.map.fastly.net
www.pinterest.co.kr	prod.pinterest.global.map.fastly.net
pinterest.com.mx	prod.pinterest.global.map.fastly.net
www.pinterest.com.mx	prod.pinterest.global.map.fastly.net
pinterest.nz	prod.pinterest.global.map.fastly.net
www.pinterest.nz	prod.pinterest.global.map.fastly.net
pinterest.pt	prod.pinterest.global.map.fastly.net
www.pinterest.pt	prod.pinterest.global.map.fastly.net
pinterest.se	prod.pinterest.global.map.fastly.net
www.pinterest.se	prod.pinterest.global.map.fastly.net
pinterest.co.uk	prod.pinterest.global.map.fastly.net
www.pinterest.co.uk	prod.pinterest.global.map.fastly.net
pin.it	prod.pinterest.global.map.fastly.net
pinimg.com	prod.pinterest.global.map.fastly.net
h2.pinimg.com	dualstack.h2.pinterest.map.fastly.net
i.pinimg.com	i.pinimg.com.edgekey.net
media-cache-ak0.pinimg.com	prod.pinterest.global.map.fastly.net
media-cache-ak1.pinimg.com	prod.pinterest.global.map.fastly.net
media-cache-ak2.pinimg.com	i.pinimg.com.edgekey.net
media-cache-ak3.pinimg.com	prod.pinterest.global.map.fastly.net
media-cache-ec0.pinimg.com	i.pinimg.com.edgekey.net
media-cache-ec1.pinimg.com	i.pinimg.com.edgekey.net
media-cache-ec2.pinimg.com	prod.pinterest.global.map.fastly.net
media-cache-ec3.pinimg.com	i.pinimg.com.edgekey.net
media-cache-ec4.pinimg.com	prod.pinterest.global.map.fastly.net
media-cache-ec6.pinimg.com	prod.pinterest.global.map.fastly.net
s.pinimg.com	prod.pinterest.global.map.fastly.net
s-media-cache-ak0.pinimg.com	prod.pinterest.global.map.fastly.net
s-media-cache-ec0.pinimg.com	prod.pinterest.global.map.fastly.net
s-passets.pinimg.com	prod.pinterest.global.map.fastly.net
s-passets-cache-ak0.pinimg.com	prod.pinterest.global.map.fastly.net
s-passets-ec.pinimg.com	prod.pinterest.global.map.fastly.net
v.pinimg.com	i.pinimg.com.edgekey.net

# Twitter
twitter.com	twitter.com
www.twitter.com	twitter.com
2010.twitter.com	s.twitter.com
2011.twitter.com	s.twitter.com
2012.twitter.com	s.twitter.com
2013.twitter.com	s.twitter.com
2014.twitter.com	s.twitter.com
2015.twitter.com	s.twitter.com
about.twitter.com	s.twitter.com
analytics.twitter.com	s.twitter.com
api.twitter.com	-
apiwiki.twitter.com	s.twitter.com
apps.twitter.com	s.twitter.com
assets0.twitter.com	s.twitter.com
assets1.twitter.com	s.twitter.com
assets2.twitter.com	s.twitter.com
assets3.twitter.com	s.twitter.com
assets4.twitter.com	s.twitter.com
blog.twitter.com	s.twitter.com
business.twitter.com	s.twitter.com
caps.twitter.com	s.twitter.com
cards.twitter.com	s.twitter.com
cards-dev.twitter.com	s.twitter.com
careers.twitter.com	s.twitter.com
dev.twitter.com	s.twitter.com
developer.twitter.com	s.twitter.com
engineering.twitter.com	s.twitter.com
fonts.twitter.com	s.twitter.com
help.twitter.com	s.twitter.com
interactive.twitter.com	s.twitter.com
lite.twitter.com	s.twitter.com
m.twitter.com	s.twitter.com
marketing.twitter.com	s.twitter.com
media.twitter.com	s.twitter.com
mobile.twitter.com	-
music.twitter.com	s.twitter.com
partnerstream1.twitter.com	stream.twitter.com
partnerstream2.twitter.com	stream.twitter.com
pay.twitter.com	-
pic.twitter.com	s.twitter.com
platform.twitter.com	cs41.wac.edgecastcdn.net
widgets.platform.twitter.com	cs479.wac.edgecastcdn.net
publish.twitter.com	-
research.twitter.com	s.twitter.com
search.twitter.com	s.twitter.com
sitestream.twitter.com	-
static.twitter.com	s.twitter.com
status.twitter.com	cs322.wac.edgecastcdn.net
stream.twitter.com	stream.twitter.com
studio.twitter.com	s.twitter.com
support.twitter.com	-
syndication.twitter.com	-
cdn.syndication.twitter.com	cdn-eb.syndication.twitter.com
ton.twitter.com	-
transparency.twitter.com	s.twitter.com
tweetdeck.twitter.com	td.twitter.com
upload.twitter.com	-
userstream.twitter.com	-
yearinreview.twitter.com	s.twitter.com
t.co	t.co
www.t.co	t.co
tweetdeck.com	td.twitter.com
www.tweetdeck.com	td.twitter.com
api.tweetdeck.com	td.twitter.com
assets.tweetdeck.com	s.twitter.com
blog.tweetdeck.com	td.twitter.com
downloads.tweetdeck.com	td.twitter.com
support.tweetdeck.com	td.twitter.com
tracking.tweetdeck.com	td.twitter.com
web.tweetdeck.com	td.twitter.com
abs.twimg.com	cs672.wac.edgecastcdn.net
abs-0.twimg.com	abs-zero.twimg.com
amp.twimg.com	wildcard.twimg.com
amp-0.twimg.com	amp-zero.twimg.com
dnt.twimg.com	cs672.wac.edgecastcdn.net
ea.twimg.com	cs672.wac.edgecastcdn.net
g.twimg.com	cs672.wac.edgecastcdn.net
g2.twimg.com	cs672.wac.edgecastcdn.net
gu.twimg.com	cs672.wac.edgecastcdn.net
hca.twimg.com	cs672.wac.edgecastcdn.net
image-proxy-origin.twimg.com	-
ipv6.twimg.com	wildcard.twimg.com
jp.twimg.com	cs672.wac.edgecastcdn.net
l.twimg.com	s.twitter.com
f.e.lv.twimg.com	-
ft.e.lv.twimg.com	ft.e.lv.twimg.com
p-ca-1.ft.e.lv.twimg.com	ft.e.lv.twimg.com
p-du-1.ft.e.lv.twimg.com	ft.e.lv.twimg.com
p-fr-1.ft.e.lv.twimg.com	ft.e.lv.twimg.com
p-sel-1.ft.e.lv.twimg.com	ft.e.lv.twimg.com
p-sg-1.ft.e.lv.twimg.com	ft.e.lv.twimg.com
p-syd-1.ft.e.lv.twimg.com	ft.e.lv.twimg.com
p-tyo-1.ft.e.lv.twimg.com	ft.e.lv.twimg.com
p-va-1.ft.e.lv.twimg.com	ft.e.lv.twimg.com
t-ca-1.ft.e.lv.twimg.com	ft.e.lv.twimg.com
p-ca-1.e.lv.twimg.com	ft.e.lv.twimg.com
p-du-1.e.lv.twimg.com	ft.e.lv.twimg.com
p-fr-1.e.lv.twimg.com	ft.e.lv.twimg.com
p-sel-1.e.lv.twimg.com	ft.e.lv.twimg.com
p-sg-1.e.lv.twimg.com	ft.e.lv.twimg.com
p-syd-1.e.lv.twimg.com	ft.e.lv.twimg.com
p-tyo-1.e.lv.twimg.com	ft.e.lv.twimg.com
p-va-1.e.lv.twimg.com	ft.e.lv.twimg.com
t-ca-1.e.lv.twimg.com	ft.e.lv.twimg.com
hlslive-akc.med1.m.lv.twimg.com	a1512.w16.akamai.net
hlslive-akcg1.med1.m.lv.twimg.com	a1934.w16.akamai.net
hlslive-akcg2.med1.m.lv.twimg.com	a1228.w16.akamai.net
hlslive-akcg3.med1.m.lv.twimg.com	a1861.dscd.akamai.net
hlslive-akcg4.med1.m.lv.twimg.com	a1062.dscd.akamai.net
hlslive-akcg5.med1.m.lv.twimg.com	a468.dscw16.akamai.net
hlslive-akcg6.med1.m.lv.twimg.com	a1545.dscd.akamai.net
hlslive-akcg7.med1.m.lv.twimg.com	a498.dscd.akamai.net
hlslive-akcg8.med1.m.lv.twimg.com	a1741.dscd.akamai.net
hlslive-akcg9.med1.m.lv.twimg.com	a1058.dscd.akamai.net
hlslive-akcg10.med1.m.lv.twimg.com	a1215.dscd.akamai.net
hlslive-akcg11.med1.m.lv.twimg.com	a1138.dscd.akamai.net
hlslive-akcg12.med1.m.lv.twimg.com	a1652.dscd.akamai.net
hlslive-akcg13.med1.m.lv.twimg.com	a105.dscd.akamai.net
hlslive-akcg14.med1.m.lv.twimg.com	a37.dscd.akamai.net
hlslive-akcg15.med1.m.lv.twimg.com	a1889.dscd.akamai.net
hlslive-akcg16.med1.m.lv.twimg.com	a265.dscd.akamai.net
hlslive-akcg17.med1.m.lv.twimg.com	a305.dscd.akamai.net
hlslive-akcg18.med1.m.lv.twimg.com	a620.dscd.akamai.net
hlslive-akcg19.med1.m.lv.twimg.com	a850.dscd.akamai.net
hlslive-akcg20.med1.m.lv.twimg.com	a634.dscw16.akamai.net
hlslive-l3c.med1.m.lv.twimg.com	hlslive-l3c.med1.m.lv.twimg.com.c.footprint.net
hlslive-l3cg1.med1.m.lv.twimg.com	hlslive-l3cg1.med1.m.lv.twimg.com.c.footprint.net
hlslive-l3cg2.med1.m.lv.twimg.com	hlslive-l3cg2.med1.m.lv.twimg.com.c.footprint.net
hlslive-l3cg3.med1.m.lv.twimg.com	hlslive-l3cg3.med1.m.lv.twimg.com.c.footprint.net
hlslive-l3cg4.med1.m.lv.twimg.com	hlslive-l3cg4.med1.m.lv.twimg.com.c.footprint.net
hlslive-l3cg5.med1.m.lv.twimg.com	hlslive-l3cg5.med1.m.lv.twimg.com.c.footprint.net
hlslive-l3cg6.med1.m.lv.twimg.com	hlslive-l3cg6.med1.m.lv.twimg.com.c.footprint.net
hlslive-l3cg7.med1.m.lv.twimg.com	hlslive-l3cg7.med1.m.lv.twimg.com.c.footprint.net
hlslive-l3cg8.med1.m.lv.twimg.com	hlslive-l3cg8.med1.m.lv.twimg.com.c.footprint.net
hlslive-l3cg9.med1.m.lv.twimg.com	hlslive-l3cg9.med1.m.lv.twimg.com.c.footprint.net
hlslive-l3cg10.med1.m.lv.twimg.com	hlslive-l3cg10.med1.m.lv.twimg.com.c.footprint.net
hlslive-l3cg11.med1.m.lv.twimg.com	hlslive-l3cg11.med1.m.lv.twimg.com.c.footprint.net
hlslive-l3cg12.med1.m.lv.twimg.com	hlslive-l3cg12.med1.m.lv.twimg.com.c.footprint.net
hlslive-l3cg13.med1.m.lv.twimg.com	hlslive-l3cg13.med1.m.lv.twimg.com.c.footprint.net
hlslive-l3cg14.med1.m.lv.twimg.com	hlslive-l3cg14.med1.m.lv.twimg.com.c.footprint.net
hlslive-l3cg15.med1.m.lv.twimg.com	hlslive-l3cg15.med1.m.lv.twimg.com.c.footprint.net
hlslive-l3cg16.med1.m.lv.twimg.com	hlslive-l3cg16.med1.m.lv.twimg.com.c.footprint.net
hlslive-l3cg17.med1.m.lv.twimg.com	hlslive-l3cg17.med1.m.lv.twimg.com.c.footprint.net
hlslive-l3cg18.med1.m.lv.twimg.com	hlslive-l3cg18.med1.m.lv.twimg.com.c.footprint.net
hlslive-l3cg19.med1.m.lv.twimg.com	hlslive-l3cg19.med1.m.lv.twimg.com.c.footprint.net
hlslive-l3cg20.med1.m.lv.twimg.com	hlslive-l3cg20.med1.m.lv.twimg.com.c.footprint.net
hlslive-llc.med1.m.lv.twimg.com	twimgm1.s.llnwi.net
hlslive-llcg1.med1.m.lv.twimg.com	twimgm1.s.llnwi.net
hlslive-llcg2.med1.m.lv.twimg.com	twimgm1.s.llnwi.net
hlslive-llcg3.med1.m.lv.twimg.com	twimgm1.s.llnwi.net
hlslive-llcg4.med1.m.lv.twimg.com	twimgm1.s.llnwi.net
hlslive-llcg5.med1.m.lv.twimg.com	twimgm1.s.llnwi.net
hlslive-llcg6.med1.m.lv.twimg.com	twimgm1.s.llnwi.net
hlslive-llcg7.med1.m.lv.twimg.com	twimgm1.s.llnwi.net
hlslive-llcg8.med1.m.lv.twimg.com	twimgm1.hs.llnwd.net
hlslive-llcg9.med1.m.lv.twimg.com	twimgm1.hs.llnwd.net
hlslive-llcg10.med1.m.lv.twimg.com	twimgm1.hs.llnwd.net
hlslive-llcg11.med1.m.lv.twimg.com	twimgm1.hs.llnwd.net
hlslive-llcg12.med1.m.lv.twimg.com	twimgm1.hs.llnwd.net
hlslive-llcg13.med1.m.lv.twimg.com	twimgm1.hs.llnwd.net
hlslive-llcg14.med1.m.lv.twimg.com	twimgm1.hs.llnwd.net
hlslive-llcg15.med1.m.lv.twimg.com	twimgm1.hs.llnwd.net
hlslive-llcg16.med1.m.lv.twimg.com	twimgm1.hs.llnwd.net
hlslive-llcg17.med1.m.lv.twimg.com	twimgm1.hs.llnwd.net
hlslive-llcg18.med1.m.lv.twimg.com	twimgm1.hs.llnwd.net
hlslive-llcg19.med1.m.lv.twimg.com	twimgm1.hs.llnwd.net
hlslive-llcg20.med1.m.lv.twimg.com	twimgm1.hs.llnwd.net
hlslive-akc.med2.m.lv.twimg.com	a716.w16.akamai.net
hlslive-akcg1.med2.m.lv.twimg.com	a1949.dscd.akamai.net
hlslive-akcg2.med2.m.lv.twimg.com	a63.dscd.akamai.net
hlslive-akcg3.med2.m.lv.twimg.com	a308.dscd.akamai.net
hlslive-akcg4.med2.m.lv.twimg.com	a503.dscd.akamai.net
hlslive-akcg5.med2.m.lv.twimg.com	a415.dscw16.akamai.net
hlslive-akcg6.med2.m.lv.twimg.com	a1774.dscd.akamai.net
hlslive-akcg7.med2.m.lv.twimg.com	a1194.dscd.akamai.net
hlslive-akcg8.med2.m.lv.twimg.com	a1743.dscd.akamai.net
hlslive-akcg9.med2.m.lv.twimg.com	a1754.dscd.akamai.net
hlslive-akcg10.med2.m.lv.twimg.com	a740.dscd.akamai.net
hlslive-akcg11.med2.m.lv.twimg.com	a1194.dscd.akamai.net
hlslive-akcg12.med2.m.lv.twimg.com	a1757.dscd.akamai.net
hlslive-akcg13.med2.m.lv.twimg.com	a916.dscd.akamai.net
hlslive-akcg14.med2.m.lv.twimg.com	a1653.dscd.akamai.net
hlslive-akcg15.med2.m.lv.twimg.com	a830.dscd.akamai.net
hlslive-akcg16.med2.m.lv.twimg.com	a418.dscd.akamai.net
hlslive-akcg17.med2.m.lv.twimg.com	a671.dscd.akamai.net
hlslive-akcg18.med2.m.lv.twimg.com	a198.dscd.akamai.net
hlslive-akcg19.med2.m.lv.twimg.com	a58.dscd.akamai.net
hlslive-akcg20.med2.m.lv.twimg.com	a355.dscw16.akamai.net
hlslive-l3c.med2.m.lv.twimg.com	hlslive-l3c.med2.m.lv.twimg.com.c.footprint.net
hlslive-l3cg1.med2.m.lv.twimg.com	hlslive-l3cg1.med2.m.lv.twimg.com.c.footprint.net
hlslive-l3cg2.med2.m.lv.twimg.com	hlslive-l3cg2.med2.m.lv.twimg.com.c.footprint.net
hlslive-l3cg3.med2.m.lv.twimg.com	hlslive-l3cg3.med2.m.lv.twimg.com.c.footprint.net
hlslive-l3cg4.med2.m.lv.twimg.com	hlslive-l3cg4.med2.m.lv.twimg.com.c.footprint.net
hlslive-l3cg5.med2.m.lv.twimg.com	hlslive-l3cg5.med2.m.lv.twimg.com.c.footprint.net
hlslive-l3cg6.med2.m.lv.twimg.com	hlslive-l3cg6.med2.m.lv.twimg.com.c.footprint.net
hlslive-l3cg7.med2.m.lv.twimg.com	hlslive-l3cg7.med2.m.lv.twimg.com.c.footprint.net
hlslive-l3cg8.med2.m.lv.twimg.com	hlslive-l3cg8.med2.m.lv.twimg.com.c.footprint.net
hlslive-l3cg9.med2.m.lv.twimg.com	hlslive-l3cg9.med2.qa.m.lv.twimg.com.c.footprint.net
hlslive-l3cg10.med2.m.lv.twimg.com	hlslive-l3cg10.med2.m.lv.twimg.com.c.footprint.net
hlslive-l3cg11.med2.m.lv.twimg.com	hlslive-l3cg11.med2.m.lv.twimg.com.c.footprint.net
hlslive-l3cg12.med2.m.lv.twimg.com	hlslive-l3cg12.med2.m.lv.twimg.com.c.footprint.net
hlslive-l3cg13.med2.m.lv.twimg.com	hlslive-l3cg13.med2.m.lv.twimg.com.c.footprint.net
hlslive-l3cg14.med2.m.lv.twimg.com	hlslive-l3cg14.med2.m.lv.twimg.com.c.footprint.net
hlslive-l3cg15.med2.m.lv.twimg.com	hlslive-l3cg15.med2.m.lv.twimg.com.c.footprint.net
hlslive-l3cg16.med2.m.lv.twimg.com	hlslive-l3cg16.med2.m.lv.twimg.com.c.footprint.net
hlslive-l3cg17.med2.m.lv.twimg.com	hlslive-l3cg17.med2.m.lv.twimg.com.c.footprint.net
hlslive-l3cg18.med2.m.lv.twimg.com	hlslive-l3cg18.med2.m.lv.twimg.com.c.footprint.net
hlslive-l3cg19.med2.m.lv.twimg.com	hlslive-l3cg19.med2.m.lv.twimg.com.c.footprint.net
hlslive-l3cg20.med2.m.lv.twimg.com	hlslive-l3cg20.med2.m.lv.twimg.com.c.footprint.net
hlslive-llc.med2.m.lv.twimg.com	twimgm1.s.llnwi.net
hlslive-llcg1.med2.m.lv.twimg.com	twimgm1.s.llnwi.net
hlslive-llcg2.med2.m.lv.twimg.com	twimgm1.s.llnwi.net
hlslive-llcg3.med2.m.lv.twimg.com	twimgm1.s.llnwi.net
hlslive-llcg4.med2.m.lv.twimg.com	twimgm1.s.llnwi.net
hlslive-llcg5.med2.m.lv.twimg.com	twimgm1.s.llnwi.net
hlslive-llcg6.med2.m.lv.twimg.com	twimgm1.s.llnwi.net
hlslive-llcg7.med2.m.lv.twimg.com	twimgm1.s.llnwi.net
hlslive-llcg8.med2.m.lv.twimg.com	twimgm1.hs.llnwd.net
hlslive-llcg9.med2.m.lv.twimg.com	twimgm1.hs.llnwd.net
hlslive-llcg10.med2.m.lv.twimg.com	twimgm1.hs.llnwd.net
hlslive-llcg11.med2.m.lv.twimg.com	twimgm1.hs.llnwd.net
hlslive-llcg12.med2.m.lv.twimg.com	twimgm1.hs.llnwd.net
hlslive-llcg13.med2.m.lv.twimg.com	twimgm1.hs.llnwd.net
hlslive-llcg14.med2.m.lv.twimg.com	twimgm1.hs.llnwd.net
hlslive-llcg15.med2.m.lv.twimg.com	twimgm1.hs.llnwd.net
hlslive-llcg16.med2.m.lv.twimg.com	twimgm1.hs.llnwd.net
hlslive-llcg17.med2.m.lv.twimg.com	twimgm1.hs.llnwd.net
hlslive-llcg18.med2.m.lv.twimg.com	twimgm1.hs.llnwd.net
hlslive-llcg19.med2.m.lv.twimg.com	twimgm1.hs.llnwd.net
hlslive-llcg20.med2.m.lv.twimg.com	twimgm1.hs.llnwd.net
media-api.m.lv.twimg.com	skynet-prod-nginx-2006831559.us-west-2.elb.amazonaws.com
hlsads-akrc.us-east-1.m.lv.twimg.com	a149.dscw16.akamai.net
hlsads-l3rc.us-east-1.m.lv.twimg.com	hlsads-l3rc.us-east-1.m.lv.twimg.com.c.footprint.net
hlsads-llrc.us-east-1.m.lv.twimg.com	twimgm1.s.llnwi.net
hlsads-akrc.us-west-2.m.lv.twimg.com	a63.dscw16.akamai.net
hlsads-l3rc.us-west-2.m.lv.twimg.com	hlsads-l3rc.us-west-2.m.lv.twimg.com.c.footprint.net
hlsads-llrc.us-west-2.m.lv.twimg.com	twimgm1.s.llnwi.net
t.lv.twimg.com	-
ma.twimg.com	cs672.wac.edgecastcdn.net
ma-0.twimg.com	ma-zero.twimg.com
ma0.twimg.com	wildcard.twimg.com
ma1.twimg.com	wildcard.twimg.com
ma2.twimg.com	wildcard.twimg.com
ma3.twimg.com	wildcard.twimg.com
o.twimg.com	cs672.wac.edgecastcdn.net
o-0.twimg.com	o-zero.twimg.com
oem.twimg.com	wildcard.twimg.com
p.twimg.com	wildcard.twimg.com
pbs.twimg.com	twimg.twitter.map.fastly.net
pbs-0.twimg.com	pbs-zero.twimg.com
pbs-ec.twimg.com	cs672.wac.edgecastcdn.net
pbs-h2.twimg.com	cs45.wac.edgecastcdn.net
r.twimg.com	-
s.twimg.com	d2rdfnizen5apl.cloudfront.net
syndication.twimg.com	-
cdn.syndication.twimg.com	cs672.wac.edgecastcdn.net
syndication-o.twimg.com	-
tailfeather.twimg.com	cs672.wac.edgecastcdn.net
ton.twimg.com	cs672.wac.edgecastcdn.net
ton-0.twimg.com	ton-zero.twimg.com
tweet.twimg.com	-
twitter.twimg.com	-
video.twimg.com	eip-ntt.video.twimg.com.akahost.net
video-0.twimg.com	video-zero.twimg.com
video-ec.twimg.com	cs531.wpc.edgecastcdn.net
widgets.twimg.com	cs479.wac.edgecastcdn.net
twitpic.com	-
www.twitpic.com	-
blog.twitpic.com	-
d3.proxy03.twitpic.com	-
s1.proxy03.twitpic.com	-
d3.proxy04.twitpic.com	-
s1.proxy04.twitpic.com	-
s1.proxy05.twitpic.com	-
d3.proxy05.twitpic.com	-
web1.twitpic.com	-
web2.twitpic.com	-
web3.twitpic.com	-
web4.twitpic.com	-
web5.twitpic.com	-
web6.twitpic.com	-
web7.twitpic.com	-
web8.twitpic.com	-
web9.twitpic.com	-
web10.twitpic.com	-
web11.twitpic.com	-
web12.twitpic.com	-
web13.twitpic.com	-
web14.twitpic.com	-
web15.twitpic.com	-
web16.twitpic.com	-
web17.twitpic.com	-
web18.twitpic.com	-
web19.twitpic.com	-
web20.twitpic.com	-
web21.twitpic.com	-
web22.twitpic.com	-
web23.twitpic.com	-
web24.twitpic.com	-
web25.twitpic.com	-
web26.twitpic.com	-
web27.twitpic.com	-
web28.twitpic.com	-
web29.twitpic.com	-
web30.twitpic.com	-

# Vimeo
vimeo.com	vimeo.com
www.vimeo.com	vimeo.com
api.vimeo.com	vimeo.com
assets.vimeo.com	vimeo.map.fastly.net
captions.cloud.vimeo.com	captions-1106248301.us-east-1.elb.amazonaws.com
i.cloud.vimeo.com	-
live-api.cloud.vimeo.com	-
sentry.cloud.vimeo.com	-
u.cloud.vimeo.com	-
dev.vimeo.com	vimeo.com
developer.vimeo.com	vimeo.com
directory.vimeo.com	vimeo.com
click.email.vimeo.com	-
image.email.vimeo.com	e10205.x.akamaiedge.net
pages.email.vimeo.com	-
view.email.vimeo.com	-
help.vimeo.com	vimeo.map.fastly.net
join.vimeo.com	vimeo.map.fastly.net
making.vimeo.com	vimeo.com
origin-assets.vimeo.com	-
ott.vimeo.com	vimeo.map.fastly.net
player.vimeo.com	vimeo.map.fastly.net
press.vimeo.com	vimeo.map.fastly.net
search.vimeo.com	vimeo.com
secure.vimeo.com	vimeo.com
status.vimeo.com	vimeo.com

# WhatsApp
whatsapp.com	mmx-ds.cdn.whatsapp.net
www.whatsapp.com	mmx-ds.cdn.whatsapp.net
account.whatsapp.com	mmx-ds.cdn.whatsapp.net
alpha.whatsapp.com	w0.whatsapp.com
api.whatsapp.com	web.whatsapp.com
autodiscover.whatsapp.com	autodiscover.fb.com
beta.whatsapp.com	w0.whatsapp.com
betablog.whatsapp.com	w0.whatsapp.com
blog.whatsapp.com	w0.whatsapp.com
chat.whatsapp.com	mmx-ds.cdn.whatsapp.net
faq.whatsapp.com	mmx-ds.cdn.whatsapp.net
gamma.whatsapp.com	w0.whatsapp.com
m.whatsapp.com	w0.whatsapp.com
media.whatsapp.com	w0.whatsapp.com
translate.whatsapp.com	mmx-ds.cdn.whatsapp.net
v.whatsapp.com	w0.whatsapp.com
w0.whatsapp.com	-
web.whatsapp.com	mmx-ds.cdn.whatsapp.net
dyn.web.whatsapp.com	-
up.web.whatsapp.com	-
w1.web.whatsapp.com	dyn.web.whatsapp.com
w2.web.whatsapp.com	dyn.web.whatsapp.com
w3.web.whatsapp.com	dyn.web.whatsapp.com
w4.web.whatsapp.com	dyn.web.whatsapp.com
w5.web.whatsapp.com	dyn.web.whatsapp.com
w6.web.whatsapp.com	dyn.web.whatsapp.com
w7.web.whatsapp.com	dyn.web.whatsapp.com
w8.web.whatsapp.com	dyn.web.whatsapp.com
w9.web.whatsapp.com	dyn.web.whatsapp.com
web.whatsapp.com	mmx-ds.cdn.whatsapp.net
wwwl.whatsapp.com	-
c.whatsapp.net	-
c1.whatsapp.net	-
c2.whatsapp.net	-
c3.whatsapp.net	-
www.cdn.whatsapp.net	mmx.cdn.whatsapp.net
mmx-ds.cdn.whatsapp.net	-
mmx-fb.cdn.whatsapp.net	mmx-ds.cdn.whatsapp.net
crashlogs.whatsapp.net	mmx-ds.cdn.whatsapp.net
e1.whatsapp.net	-
e2.whatsapp.net	-
e3.whatsapp.net	-
e4.whatsapp.net	-
e5.whatsapp.net	-
e6.whatsapp.net	-
e7.whatsapp.net	-
e8.whatsapp.net	-
e9.whatsapp.net	-
e10.whatsapp.net	-
e11.whatsapp.net	-
e12.whatsapp.net	-
e13.whatsapp.net	-
e14.whatsapp.net	-
e15.whatsapp.net	-
e16.whatsapp.net	-
m.whatsapp.net	-
mme.whatsapp.net	mmg.whatsapp.net
mmg.whatsapp.net	mmx-ds.cdn.whatsapp.net
mmg-fna.whatsapp.net	mmx-fb.cdn.whatsapp.net
mmh.whatsapp.net	wacdn-1047926141.us-east-1.elb.amazonaws.com
mmi402.whatsapp.net	-
mmi403.whatsapp.net	-
mmi404.whatsapp.net	-
mmi405.whatsapp.net	-
mms.whatsapp.net	-
p.whatsapp.net	-
pps.whatsapp.net	mmx-ds.cdn.whatsapp.net
r.whatsapp.net	-
static.whatsapp.net	mmx-ds.cdn.whatsapp.net
v.whatsapp.net	v-sl.whatsapp.net
www-cdn.whatsapp.net	mmx-ds.cdn.whatsapp.net

# Yahoo
yahoo.com	atsv2-fp-shed.wg1.b.yahoo.com
www.yahoo.com	atsv2-fp-shed.wg1.b.yahoo.com
address.yahoo.com	geoycpi-uno-lite.gycpi.b.yahoodns.net
carddav.address.yahoo.com	ds-a1.ue.xobni.gycpi.b.yahoodns.net
answers.yahoo.com	fd-geoycpi-uno-deluxe.gycpi.b.yahoodns.net
hk.answers.yahoo.com	fd-geoycpi-uno-deluxe.gycpi.b.yahoodns.net
tw.answers.yahoo.com	fd-geoycpi-uno-deluxe.gycpi.b.yahoodns.net
beap-bc.yahoo.com	geoycpi-uno-deluxe.gycpi.b.yahoodns.net
tw.analytics.bid.yahoo.com	edge-auction.nevec.tw.g01.yahoodns.net
tw.api.bid.yahoo.com	edge-auction.nevec.tw.g01.yahoodns.net
tw.batch.bid.yahoo.com	edge-auction.nevec.tw.g01.yahoodns.net
tw.billing.bid.yahoo.com	yts.billing.vip.tw.g03.yahoodns.net
tw.campaign.bid.yahoo.com	edge-auction.nevec.tw.g01.yahoodns.net
tw.imgup.bid.yahoo.com	edge-auction.nevec.tw.g01.yahoodns.net
tw.master.bid.yahoo.com	edge-auction.nevec.tw.g01.yahoodns.net
tw.mb.bid.yahoo.com	edge-auction.nevec.tw.g01.yahoodns.net
tw.page.bid.yahoo.com	edge-auction.nevec.tw.g01.yahoodns.net
tw-tp2.pp.bid.yahoo.com	pp.edge.nevec.vip.tp2.yahoo.com
tw-tw1.pp.bid.yahoo.com	pp.edge.nevec.vip.tw1.yahoo.com
tw.promo.bid.yahoo.com	edge-auction.nevec.tw.g01.yahoodns.net
tw.safety.bid.yahoo.com	edge-auction.nevec.vip.tw1.yahoo.com
tw.sf.search.bid.yahoo.com	sf.srch.ect.tw.g01.yahoodns.net
tw.search.bid.yahoo.com	yts.srch.ect.tw.g01.yahoodns.net
m.tw.search.bid.yahoo.com	yts.srch.ect.tw.g01.yahoodns.net
tw.edit.store.bid.yahoo.com	edge-auction.nevec.tw.g01.yahoodns.net
tw.store.bid.yahoo.com	edge-auction.nevec.tw.g01.yahoodns.net
tw.bid.yahoo.com	edge-auction.nevec.tw.g01.yahoodns.net
m.tw.bid.yahoo.com	edge-auction.nevec.tw.g01.yahoodns.net
tw-pp-billing.bid.yahoo.com	yts.billing.vip.tw.g03.yahoodns.net
tw-pp-tcv-billing.bid.yahoo.com	yts0.bill.tcv.yahoo.com
tw-pp-twv-billing.bid.yahoo.com	yts0.bill.twv.yahoo.com
tw-prod-tp2.bid.yahoo.com	edge-auction.nevec.vip.tp2.yahoo.com
tw-prod-tw1.bid.yahoo.com	edge-auction.nevec.vip.tw1.yahoo.com
tw.user.bid.yahoo.com	edge-auction.nevec.tw.g01.yahoodns.net
brb.yahoo.com	media-router-brb1.prod.media.g03.yahoodns.net
calendar.yahoo.com	ds-geoycpi-uno-deluxe.gycpi.b.yahoodns.net
caldav.calendar.yahoo.com	ds-geoycpi-uno-deluxe.gycpi.b.yahoodns.net
comet.yahoo.com	ds-comet.yahoo.g01.yahoodns.net
pr.comet.yahoo.com	ds-comet.yahoo.pr.g03.yahoodns.net
csp.yahoo.com	csp.ue.g03.yahoodns.net
edit.yahoo.com	ds-ats.member.g02.yahoodns.net
msg.edit.yahoo.com	ds-ats.member.g02.yahoodns.net
sa.edit.yahoo.com	ds-ats.member.g02.yahoodns.net
log.fc.yahoo.com	ds-geoycpi-uno-deluxe.gycpi.b.yahoodns.net
finance.yahoo.com	oob-fo-finance-router.g03.yahoodns.net
api.finance.yahoo.com	any-finance.yahooapis.a02.yahoodns.net
autoc.finance.yahoo.com	ds-oob-fo-media-router1.prod.media.g01.yahoodns.net
beta.finance.yahoo.com	fd-geoycpi-uno-deluxe.gycpi.b.yahoodns.net
feeds.finance.yahoo.com	ds-media-router-api1.prod.media.g05.yahoodns.net
hk.finance.yahoo.com	fd-geoycpi-uno-deluxe.gycpi.b.yahoodns.net
iquery.finance.yahoo.com	ds-media-router-api1.prod.media.g05.yahoodns.net
l1-query.finance.yahoo.com	finance-yql.g04.yahoodns.net
l2-query.finance.yahoo.com	finance-yql.g04.yahoodns.net
l3-query.finance.yahoo.com	finance-yql.g04.yahoodns.net
l4-query.finance.yahoo.com	finance-yql.g04.yahoodns.net
l5-query.finance.yahoo.com	finance-yql.g04.yahoodns.net
mobile-query.finance.yahoo.com	ds-media-router-api1.prod.media.g05.yahoodns.net
partner-query.finance.yahoo.com	ds-media-router-api1.prod.media.g05.yahoodns.net
query1.finance.yahoo.com	fd-geoycpi-uno-deluxe.gycpi.b.yahoodns.net
query2.finance.yahoo.com	fd-geoycpi-uno-deluxe.gycpi.b.yahoodns.net
screen.finance.yahoo.com	fd-geoycpi-uno-deluxe.gycpi.b.yahoodns.net
screener.finance.yahoo.com	fd-geoycpi-uno-deluxe.gycpi.b.yahoodns.net
s-streamerapi.finance.yahoo.com	ds-streamerapi2.finance.a03.yahoodns.net
streamerapi.finance.yahoo.com	ds-streamerapi2.finance.a03.yahoodns.net
tw.finance.yahoo.com	twmedia.abuedge.g05.yahoodns.net
bcn.fp.yahoo.com	fp-bcn1.prod.fp.g01.yahoodns.net
fsbcn.fp.yahoo.com	fp-bcn1.prod.fp.g01.yahoodns.net
geo.yahoo.com	fam-geo-atsv2.prod.media.g03.yahoodns.net
aa.geo.yahoo.com	fam.data.g04.yahoodns.net
eu.geo.yahoo.com	fam.data.g04.yahoodns.net
help.yahoo.com	fd-geoycpi-uno.gycpi.b.yahoodns.net
analytics.help.yahoo.com	fd-geoycpi-uno.gycpi.b.yahoodns.net
en-global.help.yahoo.com	geoycpi-uno.gycpi.b.yahoodns.net
hk.help.yahoo.com	geoycpi-uno.gycpi.b.yahoodns.net
io.help.yahoo.com	fd-geoycpi-uno.gycpi.b.yahoodns.net
tw.help.yahoo.com	geoycpi-uno.gycpi.b.yahoodns.net
hk.yahoo.com	atsv2-fp-shed.wg1.b.yahoo.com
verification.hk.yahoo.com	edge-auction.nevec.tw.g01.yahoodns.net
gateway.iris.yahoo.com	gateway.a03.yahoodns.net
messenger-archive.iris.yahoo.com	iris-webarchive.g03.yahoodns.net
prod.iris.yahoo.com	gateway.a03.yahoodns.net
web.iris.yahoo.com	iris-web.g03.yahoodns.net
login.yahoo.com	ds-ats.member.g02.yahoodns.net
api.login.yahoo.com	ds-ats.member.g02.yahoodns.net
jsapi.login.yahoo.com	ds-ats.member.g02.yahoodns.net
mobile.login.yahoo.com	any-ats.member.a02.yahoodns.net
oauth.login.yahoo.com	ds-ats.member.g02.yahoodns.net
open.login.yahoo.com	ds-ats.member.g02.yahoodns.net
sbc.login.yahoo.com	ds-ats.member.g02.yahoodns.net
secure.login.yahoo.com	ds-ats.member.g02.yahoodns.net
mail.yahoo.com	fd-geoycpi-uno.gycpi.b.yahoodns.net
apis.mail.yahoo.com	fd-geoycpi-uno.gycpi.b.yahoodns.net
compose.mail.yahoo.com	ds-geoycpi-uno-lite.gycpi.b.yahoodns.net
data.mail.yahoo.com	ds-ycpi-data.xobni.g01.yahoodns.net
hk.mail.yahoo.com	ds-geoycpi-uno-lite.gycpi.b.yahoodns.net
hk-mg1.mail.yahoo.com	fd-geoycpi-uno.gycpi.b.yahoodns.net
hk-mg2.mail.yahoo.com	fd-geoycpi-uno.gycpi.b.yahoodns.net
hk-mg3.mail.yahoo.com	fd-geoycpi-uno.gycpi.b.yahoodns.net
hk-mg4.mail.yahoo.com	fd-geoycpi-uno.gycpi.b.yahoodns.net
hk-mg5.mail.yahoo.com	fd-geoycpi-uno.gycpi.b.yahoodns.net
hk-mg6.mail.yahoo.com	fd-geoycpi-uno.gycpi.b.yahoodns.net
hk-mg10.mail.yahoo.com	fd-geoycpi-uno.gycpi.b.yahoodns.net
hk-mg25.mail.yahoo.com	fd-geoycpi-uno.gycpi.b.yahoodns.net
hk-mg30.mail.yahoo.com	geoycpi-uno.gycpi.b.yahoodns.net
hk-mg31.mail.yahoo.com	fd-geoycpi-uno.gycpi.b.yahoodns.net
hk-mg40.mail.yahoo.com	fd-geoycpi-uno.gycpi.b.yahoodns.net
hk-mg41.mail.yahoo.com	fd-geoycpi-uno.gycpi.b.yahoodns.net
hk-mg42.mail.yahoo.com	fd-geoycpi-uno.gycpi.b.yahoodns.net
hk-mg50.mail.yahoo.com	fd-geoycpi-uno.gycpi.b.yahoodns.net
hk-mg60.mail.yahoo.com	fd-geoycpi-uno.gycpi.b.yahoodns.net
hk-mg61.mail.yahoo.com	fd-geoycpi-uno.gycpi.b.yahoodns.net
imap.mail.yahoo.com	internal.imap.mail.g03.yahoodns.net
android.imap.mail.yahoo.com	internal.imap.mail.g03.yahoodns.net
apple.imap.mail.yahoo.com	internal.imap.mail.g03.yahoodns.net
htc.imap.mail.yahoo.com	internal.imap.mail.g03.yahoodns.net
nokia-free.imap.mail.yahoo.com	internal.imap.mail.g03.yahoodns.net
rim.imap.mail.yahoo.com	internal.imap.mail.g03.yahoodns.net
samsung.imap.mail.yahoo.com	internal.imap.mail.g03.yahoodns.net
tim.imap.mail.yahoo.com	internal.imap.mail.g03.yahoodns.net
winmetro.imap.mail.yahoo.com	internal.imap.mail.g03.yahoodns.net
winmo.imap.mail.yahoo.com	internal.imap.mail.g03.yahoodns.net
mailplus.mail.yahoo.com	ds-geoycpi-uno-lite.gycpi.b.yahoodns.net
tw.mailplus.mail.yahoo.com	ds-geoycpi-uno-lite.gycpi.b.yahoodns.net
mg.mail.yahoo.com	fd-geoycpi-uno.gycpi.b.yahoodns.net
m.mg.mail.yahoo.com	fd-geoycpi-uno.gycpi.b.yahoodns.net
mobile.mail.yahoo.com	fd-geoycpi-uno.gycpi.b.yahoodns.net
smtp.mobile.mail.yahoo.com	smtp-mob.biz.mail.global.gm0.yahoodns.net
overview.mail.yahoo.com	ds-geoycpi-uno-lite.gycpi.b.yahoodns.net
hk.overview.mail.yahoo.com	ds-geoycpi-uno-lite.gycpi.b.yahoodns.net
sg.overview.mail.yahoo.com	ds-geoycpi-uno-lite.gycpi.b.yahoodns.net
tw.overview.mail.yahoo.com	ds-geoycpi-uno-lite.gycpi.b.yahoodns.net
us.overview.mail.yahoo.com	ds-geoycpi-uno-lite.gycpi.b.yahoodns.net
payments.mail.yahoo.com	geoycpi-uno-lite.gycpi.b.yahoodns.net
pop.mail.yahoo.com	global-jpop.mail.gm0.yahoodns.net
legacy.pop.mail.yahoo.com	global-jpop.mail.gm0.yahoodns.net
plus.pop.mail.yahoo.com	global-jpop.mail.gm0.yahoodns.net
prod1psearch.mail.yahoo.com	ds-a1.ue.xobni.gycpi.b.yahoodns.net
sg.mail.yahoo.com	ds-geoycpi-uno-lite.gycpi.b.yahoodns.net
sg-mg1.mail.yahoo.com	fd-geoycpi-uno.gycpi.b.yahoodns.net
sg-mg2.mail.yahoo.com	fd-geoycpi-uno.gycpi.b.yahoodns.net
sg-mg3.mail.yahoo.com	fd-geoycpi-uno.gycpi.b.yahoodns.net
sg-mg4.mail.yahoo.com	fd-geoycpi-uno.gycpi.b.yahoodns.net
sg-mg5.mail.yahoo.com	fd-geoycpi-uno.gycpi.b.yahoodns.net
sg-mg6.mail.yahoo.com	fd-geoycpi-uno.gycpi.b.yahoodns.net
sg-mg10.mail.yahoo.com	fd-geoycpi-uno.gycpi.b.yahoodns.net
sg-mg25.mail.yahoo.com	fd-geoycpi-uno.gycpi.b.yahoodns.net
sg-mg30.mail.yahoo.com	geoycpi-uno.gycpi.b.yahoodns.net
sg-mg31.mail.yahoo.com	fd-geoycpi-uno.gycpi.b.yahoodns.net
sg-mg40.mail.yahoo.com	fd-geoycpi-uno.gycpi.b.yahoodns.net
sg-mg41.mail.yahoo.com	fd-geoycpi-uno.gycpi.b.yahoodns.net
sg-mg42.mail.yahoo.com	fd-geoycpi-uno.gycpi.b.yahoodns.net
sg-mg50.mail.yahoo.com	fd-geoycpi-uno.gycpi.b.yahoodns.net
sg-mg60.mail.yahoo.com	fd-geoycpi-uno.gycpi.b.yahoodns.net
sg-mg61.mail.yahoo.com	fd-geoycpi-uno.gycpi.b.yahoodns.net
smtp.mail.yahoo.com	smtp.mail.global.gm0.yahoodns.net
android.smtp.mail.yahoo.com	star.smtp.mail.global.gm0.yahoodns.net
apple.smtp.mail.yahoo.com	smtp-mob.biz.mail.global.gm0.yahoodns.net
htc.smtp.mail.yahoo.com	star.smtp.mail.global.gm0.yahoodns.net
plus.smtp.mail.yahoo.com	star.smtp.mail.global.gm0.yahoodns.net
rim.smtp.mail.yahoo.com	smtp-mob.biz.mail.global.gm0.yahoodns.net
samsung.smtp.mail.yahoo.com	smtp-mob.biz.mail.global.gm0.yahoodns.net
tim.smtp.mail.yahoo.com	smtp-mob.biz.mail.global.gm0.yahoodns.net
winmetro.smtp.mail.yahoo.com	star.smtp.mail.global.gm0.yahoodns.net
winmo.smtp.mail.yahoo.com	smtp-mob.biz.mail.global.gm0.yahoodns.net
tw.mail.yahoo.com	ds-geoycpi-uno-lite.gycpi.b.yahoodns.net
tw-mg1.mail.yahoo.com	fd-geoycpi-uno.gycpi.b.yahoodns.net
tw-mg2.mail.yahoo.com	fd-geoycpi-uno.gycpi.b.yahoodns.net
tw-mg3.mail.yahoo.com	fd-geoycpi-uno.gycpi.b.yahoodns.net
tw-mg4.mail.yahoo.com	fd-geoycpi-uno.gycpi.b.yahoodns.net
tw-mg5.mail.yahoo.com	fd-geoycpi-uno.gycpi.b.yahoodns.net
tw-mg6.mail.yahoo.com	fd-geoycpi-uno.gycpi.b.yahoodns.net
tw-mg10.mail.yahoo.com	fd-geoycpi-uno.gycpi.b.yahoodns.net
tw-mg25.mail.yahoo.com	fd-geoycpi-uno.gycpi.b.yahoodns.net
tw-mg30.mail.yahoo.com	geoycpi-uno.gycpi.b.yahoodns.net
tw-mg31.mail.yahoo.com	fd-geoycpi-uno.gycpi.b.yahoodns.net
tw-mg40.mail.yahoo.com	fd-geoycpi-uno.gycpi.b.yahoodns.net
tw-mg41.mail.yahoo.com	fd-geoycpi-uno.gycpi.b.yahoodns.net
tw-mg42.mail.yahoo.com	fd-geoycpi-uno.gycpi.b.yahoodns.net
tw-mg50.mail.yahoo.com	fd-geoycpi-uno.gycpi.b.yahoodns.net
tw-mg60.mail.yahoo.com	fd-geoycpi-uno.gycpi.b.yahoodns.net
tw-mg61.mail.yahoo.com	fd-geoycpi-uno.gycpi.b.yahoodns.net
us.mail.yahoo.com	ds-geoycpi-uno-lite.gycpi.b.yahoodns.net
us-mg1.mail.yahoo.com	fd-geoycpi-uno.gycpi.b.yahoodns.net
us-mg2.mail.yahoo.com	fd-geoycpi-uno.gycpi.b.yahoodns.net
us-mg3.mail.yahoo.com	fd-geoycpi-uno.gycpi.b.yahoodns.net
us-mg4.mail.yahoo.com	fd-geoycpi-uno.gycpi.b.yahoodns.net
us-mg5.mail.yahoo.com	fd-geoycpi-uno.gycpi.b.yahoodns.net
us-mg6.mail.yahoo.com	fd-geoycpi-uno.gycpi.b.yahoodns.net
us-mg10.mail.yahoo.com	fd-geoycpi-uno.gycpi.b.yahoodns.net
us-mg25.mail.yahoo.com	fd-geoycpi-uno.gycpi.b.yahoodns.net
us-mg30.mail.yahoo.com	geoycpi-uno.gycpi.b.yahoodns.net
us-mg31.mail.yahoo.com	fd-geoycpi-uno.gycpi.b.yahoodns.net
us-mg40.mail.yahoo.com	fd-geoycpi-uno.gycpi.b.yahoodns.net
us-mg41.mail.yahoo.com	fd-geoycpi-uno.gycpi.b.yahoodns.net
us-mg42.mail.yahoo.com	fd-geoycpi-uno.gycpi.b.yahoodns.net
us-mg50.mail.yahoo.com	fd-geoycpi-uno.gycpi.b.yahoodns.net
us-mg60.mail.yahoo.com	fd-geoycpi-uno.gycpi.b.yahoodns.net
us-mg61.mail.yahoo.com	fd-geoycpi-uno.gycpi.b.yahoodns.net
ws-contacts.mail.yahoo.com	ds-ycpi-prod4cws.xobni.g03.yahoodns.net
tw.analytics.mall.yahoo.com	analytics.ec.tw.g03.yahoodns.net
tw.batch.mall.yahoo.com	tw.batch.mall.g03.yahoodns.net
tw-b2-sc.beta.mall.yahoo.com	sb.edge.nevec.vip.tw1.yahoo.com
tw.campaign.mall.yahoo.com	list.mall.tw.g1.b.yahoo.com
tw.cst.mall.yahoo.com	cst.mall.tw.g1.b.yahoo.com
tw.edmbc.mall.yahoo.com	edmbc.mall.tw.g01.yahoodns.net
tw.mapi.mall.yahoo.com	mapi.mall.tw.g00.yahoodns.net
tw.page.mall.yahoo.com	list.mall.tw.g1.b.yahoo.com
tw.rcv.mall.yahoo.com	rcv.mall.tw.g01.yahoodns.net
tw.sapi.mall.yahoo.com	sapi.mall.tw.g1.b.yahoo.com
tw.sc.mall.yahoo.com	sc.mall.tw.g1.b.yahoo.com
tw.sf.search.mall.yahoo.com	sf.srch.ect.tw.g01.yahoodns.net
tw.search.mall.yahoo.com	yts.srch.ect.tw.g01.yahoodns.net
m.tw.search.mall.yahoo.com	yts.srch.ect.tw.g01.yahoodns.net
tw.mall.yahoo.com	list.mall.tw.g1.b.yahoo.com
m.tw.mall.yahoo.com	list.mall.tw.g1.b.yahoo.com
tw.user.mall.yahoo.com	user.mall.tw.g1.b.yahoo.com
tw.user-test.mall.yahoo.com	list.mall.tw.g1.b.yahoo.com
messenger.yahoo.com	ds-geoycpi-uno-deluxe.gycpi.b.yahoodns.net
fantasy.messenger.yahoo.com	ds-geoycpi-uno-deluxe.gycpi.b.yahoodns.net
hk.messenger.yahoo.com	ds-geoycpi-uno-deluxe.gycpi.b.yahoodns.net
tw.messenger.yahoo.com	any-src.san2.a01.yahoodns.net
us.messenger.yahoo.com	ds-geoycpi-uno-deluxe.gycpi.b.yahoodns.net
mlogin.yahoo.com	ds-ats.member.g02.yahoodns.net
hk.mobi.yahoo.com	r100.mobile.twfp.g03.yahoodns.net
tw.mobi.yahoo.com	r100.mobile.twfp.g03.yahoodns.net
news.yahoo.com	ds-oob-fo-media-router1.prod.media.g01.yahoodns.net
hk.news.yahoo.com	abu-media-router.g03.yahoodns.net
rss.news.yahoo.com	oob-media-router-rc1.prod.media.wg1.b.yahoo.com
sg.news.yahoo.com	ds-oob-fo-media-router1.prod.media.g01.yahoodns.net
tw.news.yahoo.com	abu-media-router.g03.yahoodns.net
policies.yahoo.com	fd-geoycpi-uno.gycpi.b.yahoodns.net
ws.progrss.yahoo.com	ws.progrss.a04.yahoodns.net
tw.promo.yahoo.com	edge-auction.nevec.tw.g01.yahoodns.net
analytics.query.yahoo.com	ds-geoycpi-uno-lite.gycpi.b.yahoodns.net
apple-finance.query.yahoo.com	geo-applefinance-cache.internal.query.g03.yahoodns.net
fantasysports.query.yahoo.com	classic-yql.g05.yahoodns.net
finance.query.yahoo.com	ds-media-router-api1.prod.media.g05.yahoodns.net
geo.query.yahoo.com	ds-geoycpi-uno-lite.gycpi.b.yahoodns.net
locdrop.query.yahoo.com	geo-yql.g05.yahoodns.net
onepush.query.yahoo.com	ds-geoycpi-uno-lite.gycpi.b.yahoodns.net
sports.query.yahoo.com	classic-yql.g05.yahoodns.net
us-locdrop.query.yahoo.com	geo-yql.g05.yahoodns.net
yvap.query.yahoo.com	a1.ue.yvap.g04.yahoodns.net
hk.rd.yahoo.com	twmedia.abuedge.g05.yahoodns.net
sg.rd.yahoo.com	src.g03.yahoodns.net
tw.rd.yahoo.com	twmedia.abuedge.g05.yahoodns.net
screen.yahoo.com	oob-media-router-rc1.prod.media.wg1.b.yahoo.com
beta.screen.yahoo.com	oob-media-router-rc1.prod.media.wg1.b.yahoo.com
hk.screen.yahoo.com	ds-oob-fo-media-router1.prod.media.g01.yahoodns.net
sg.screen.yahoo.com	ds-oob-fo-media-router1.prod.media.g01.yahoodns.net
tw.screen.yahoo.com	ds-oob-fo-media-router1.prod.media.g01.yahoodns.net
search.yahoo.com	ds-global3.l7.search.ystg1.b.yahoo.com
dictionary.search.yahoo.com	ds-global3.l7.search.ystg1.b.yahoo.com
hk.dictionary.search.yahoo.com	ds-global3.l7.search.ystg1.b.yahoo.com
tw.dictionary.search.yahoo.com	ds-global3.l7.search.ystg1.b.yahoo.com
hk.search.yahoo.com	ds-global3.l7.search.ystg1.b.yahoo.com
images.search.yahoo.com	ds-global3.l7.search.ystg1.b.yahoo.com
hk.images.search.yahoo.com	ds-global3.l7.search.ystg1.b.yahoo.com
sg.images.search.yahoo.com	ds-global3.l7.search.ystg1.b.yahoo.com
tw.images.search.yahoo.com	ds-global3.l7.search.ystg1.b.yahoo.com
m.search.yahoo.com	ds-global3.l7.search.ystg1.b.yahoo.com
r.search.yahoo.com	ds-global3.l7.search.ystg1.b.yahoo.com
sg.search.yahoo.com	ds-global3.l7.search.ystg1.b.yahoo.com
tw.search.yahoo.com	ds-global3.l7.search.ystg1.b.yahoo.com
us.search.yahoo.com	ds-global3.l7.search.ystg1.b.yahoo.com
video.search.yahoo.com	ds-global3.l7.search.ystg1.b.yahoo.com
hk.video.search.yahoo.com	ds-global3.l7.search.ystg1.b.yahoo.com
sg.video.search.yahoo.com	ds-global3.l7.search.ystg1.b.yahoo.com
tw.video.search.yahoo.com	ds-global3.l7.search.ystg1.b.yahoo.com
edit.secure.yahoo.com	ds-ats.member.g02.yahoodns.net
full-ruler.secure.yahoo.com	ds-geoycpi-uno-deluxe.gycpi.b.yahoodns.net
lh.secure.yahoo.com	fd-geoycpi-uno.gycpi.b.yahoodns.net
min-ruler.secure.yahoo.com	ds-geoycpi-uno-deluxe.gycpi.b.yahoodns.net
real-full-ruler.secure.yahoo.com	real.full.ruler.ycpi.gycpi.b.yahoodns.net
real-min-ruler.secure.yahoo.com	real.min.ruler.ycpi.gycpi.b.yahoodns.net
rtb-pclick.secure.yahoo.com	fd-geoycpi-uno.gycpi.b.yahoodns.net
tw.yahoo.com	atsv2-fp-shed.wg1.b.yahoo.com
udc.yahoo.com	ds-geoycpi-uno-lite.gycpi.b.yahoodns.net
upcoming.yahoo.com	src.g03.yahoodns.net
video.yahoo.com	fd-geoycpi-uno-deluxe.gycpi.b.yahoodns.net
bats.video.yahoo.com	geoycpi-uno-deluxe.gycpi.b.yahoodns.net
guide.video.yahoo.com	geoycpi-uno.gycpi.b.yahoodns.net
hk.video.yahoo.com	twmedia.abuedge.g05.yahoodns.net
tw.video.yahoo.com	twmedia.abuedge.g05.yahoodns.net
yep.video.yahoo.com	ds-geoycpi-uno-deluxe.gycpi.b.yahoodns.net
yql.video.yahoo.com	geoycpi-uno.gycpi.b.yahoodns.net
proddata.xobni.yahoo.com	ds-geoycpi-uno-lite.gycpi.b.yahoodns.net
bid-global.ybp.yahoo.com	bid-global.ybp.gysm.yahoodns.net
east-bid.ybp.yahoo.com	bid-east.pbp.vip.bf1.yahoo.com
pmp.ybp.yahoo.com	bid-global.ybp.gysm.yahoodns.net
pr.ybp.yahoo.com	ds-ycpi-pr-ybp.gysm.yahoodns.net
pr-apac.ybp.yahoo.com	ds-ycpi-pr-ybp.gysm.yahoodns.net
pr-bh.ybp.yahoo.com	ds-pr-bh.ybp.gysm.yahoodns.net
pr-bucket.ybp.yahoo.com	pr-bucket.ybp.gysm.yahoodns.net
pr-emea.ybp.yahoo.com	ds-ycpi-pr-ybp.gysm.yahoodns.net
abumedia.yql.yahoo.com	r1.edge.media.tw.g05.yahoodns.net
news-app.abumedia.yql.yahoo.com	twmedia.abuedge.g05.yahoodns.net
stock-app.abumedia.yql.yahoo.com	twmedia.abuedge.g05.yahoodns.net
auction.yql.yahoo.com	ue.ec.tw.g01.yahoodns.net
ec.yql.yahoo.com	ue.ec.tw.g01.yahoodns.net
mall.yql.yahoo.com	ue.ec.tw.g01.yahoodns.net
mep-partner.media.yql.yahoo.com	mep-partner-yql.media.g05.yahoodns.net
video.media.yql.yahoo.com	geoycpi-uno.gycpi.b.yahoodns.net
weather-mobile.media.yql.yahoo.com	weather-flickr-yql.g05.yahoodns.net
video-api.yql.yahoo.com	geoycpi-uno.gycpi.b.yahoodns.net
video-api-internal.yql.yahoo.com	video-yql-omega.g04.yahoodns.net
order.yahoo.com.tw	edge-windows.nevec.tw.g01.yahoodns.net
m.order.yahoo.com.tw	list.mall.tw.g1.b.yahoo.com
answers.yahooapis.com	fd-geoycpi-uno-deluxe.gycpi.b.yahoodns.net
tw.bid.yahooapis.com	edge-auction.nevec.tw.g01.yahoodns.net
bp.yahooapis.com	l.gycs.b.yahoodns.net
cdn.yahooapis.com	l.gycs.b.yahoodns.net
developer.yahooapis.com	ws1.ydn1.vip.gq1.yahoo.com
fantasysports.yahooapis.com	fantasy.edge.g03.yahoodns.net
open.login.yahooapis.com	ds-ats.member.g02.yahoodns.net
tw.batch.mall.yahooapis.com	tw.batch.mall.g03.yahoodns.net
tw.ews.mall.yahooapis.com	ews.mall.tw.g03.yahoodns.net
pipes.yahooapis.com	geoycpi-uno.gycpi.b.yahoodns.net
polyfills.yahooapis.com	ue-polyester.g03.yahoodns.net
query.yahooapis.com	query.yahooapis.omega.g03.yahoodns.net
apple-mobile.query.yahooapis.com	apple-weather-yql.media.g04.yahoodns.net
samsung-mobile.query.yahooapis.com	ds-media-router-api1.prod.media.g05.yahoodns.net
social.yahooapis.com	geoycpi-uno.gycpi.b.yahoodns.net
upcoming.yahooapis.com	oob-media-router-rc1.prod.media.wg1.b.yahoo.com
webplayer.yahooapis.com	l.gycs.b.yahoodns.net
yboss.yahooapis.com	global3.l7.search.ystg1.b.yahoo.com
mobileweather.yql.yahooapis.com	weather-flickr-yql.g05.yahoodns.net
ysp.yahooapis.com	global3.l7.search.ystg1.b.yahoo.com
yui.yahooapis.com	s.gycs.b.yahoodns.net
yui-s.yahooapis.com	s.gycs.b.yahoodns.net
ct.yimg.com	ct2.gycs.b.yahoodns.net
d.yimg.com	s.gycs.b.yahoodns.net
e.yimg.com	l.gycs.b.yahoodns.net
ec.yimg.com	fd-geo-ec.gy1.b.yahoodns.net
ep.yimg.com	p.gycs.b.yahoodns.net
h.yimg.com	h.gycs.b.yahoodns.net
l.yimg.com	s.gycs.b.yahoodns.net
l1.yimg.com	l.gycs.b.yahoodns.net
l2.yimg.com	l.gycs.b.yahoodns.net
l3.yimg.com	l.gycs.b.yahoodns.net
p.yimg.com	p.gycs.b.yahoodns.net
s.yimg.com	s.gycs.b.yahoodns.net
s1.yimg.com	s.gycs.b.yahoodns.net
s2.yimg.com	s.gycs.b.yahoodns.net
s3.yimg.com	s.gycs.b.yahoodns.net
sec.yimg.com	p.gycs.b.yahoodns.net
sep.yimg.com	sep.gycs.b.yahoodns.net
sp.yimg.com	s.gycs.b.yahoodns.net
sxh.yimg.com	sxh.gycs.b.yahoodns.net
tw.yimg.com	twmedia.abuedge.g05.yahoodns.net
xa.yimg.com	media.groups.g03.yahoodns.net
